acaryochloris_marina	prauserella_marina	nh4_e,
prauserella_marina	acaryochloris_marina	h2o_e,
acetoanaerobium_sticklandii	dethiosulfovibrio_peptidovorans	h2o_e,h_e,h2s_e,
dethiosulfovibrio_peptidovorans	acetoanaerobium_sticklandii	ala__L_e,
acetobacter_ghanensis	taylorella_asinigenitalis	pi_e,glyclt_e,fe2_e,
taylorella_asinigenitalis	acetobacter_ghanensis	glu__L_e,asp__L_e,
acetobacterium_woodii	mediterranea_massiliensis	h2_e,h_e,
mediterranea_massiliensis	acetobacterium_woodii	nh4_e,pi_e,
acetobacter_okinawensis	alkalispirochaeta_odontotermitis	
alkalispirochaeta_odontotermitis	acetobacter_okinawensis	no2_e,nh4_e,ura_e,
acetobacter_papayae	lactobacillus_thailandensis	
lactobacillus_thailandensis	acetobacter_papayae	
acetobacter_pasteurianus	methylomonas_denitrificans	
methylomonas_denitrificans	acetobacter_pasteurianus	h2o_e,
acetobacter_persici	intrasporangium_chromatireducens	h2o_e,
intrasporangium_chromatireducens	acetobacter_persici	pi_e,
acetobacter_persici	paenibacillus_herberti	
paenibacillus_herberti	acetobacter_persici	
acetobacter_senegalensis	granulosicoccus_antarcticus	
granulosicoccus_antarcticus	acetobacter_senegalensis	pi_e,
acetohalobium_arabaticum	paludibacter_propionicigenes	acald_e,ade_e,
paludibacter_propionicigenes	acetohalobium_arabaticum	h2o_e,nh4_e,fe2_e,
acetomicrobium_hydrogeniformans	rufibacter_ruber	gly_e,
rufibacter_ruber	acetomicrobium_hydrogeniformans	
acetomicrobium_mobile	granulicella_tundricola	h_e,fe2_e,lac__L_e,
granulicella_tundricola	acetomicrobium_mobile	gly_e,
acholeplasma_brassicae	sunxiuqinia_elliptica	asp__L_e,nh4_e,ura_e,orn_e,fe2_e,
sunxiuqinia_elliptica	acholeplasma_brassicae	h2o_e,
acholeplasma_laidlawii	thiobacillus_denitrificans	nh4_e,asp__L_e,
thiobacillus_denitrificans	acholeplasma_laidlawii	
acholeplasma_oculi	deefgea_rivuli	nh4_e,
deefgea_rivuli	acholeplasma_oculi	
acholeplasma_oculi	thermodesulfobacterium_geofontis	h2o_e,ile__L_e,
thermodesulfobacterium_geofontis	acholeplasma_oculi	
acholeplasma_palmae	petrotoga_mobilis	h2o_e,acald_e,
petrotoga_mobilis	acholeplasma_palmae	h_e,
acholeplasma_palmae	spirosoma_luteum	acald_e,no2_e,fe2_e,cu2_e,
spirosoma_luteum	acholeplasma_palmae	pi_e,
acidaminococcus_fermentans	christensenella_minuta	glu__L_e,gly_e,
christensenella_minuta	acidaminococcus_fermentans	
acidaminococcus_fermentans	faecalibaculum_rodentium	
faecalibaculum_rodentium	acidaminococcus_fermentans	h2o_e,
acidaminococcus_fermentans	kallipyga_massiliensis	ura_e,
kallipyga_massiliensis	acidaminococcus_fermentans	h2o_e,h_e,ala__L_e,lac__L_e,
acidaminococcus_fermentans	lachnospiraceae_bacterium	ura_e,
lachnospiraceae_bacterium	acidaminococcus_fermentans	h2o_e,
acidaminococcus_fermentans	lachnospiraceae_bacterium	ura_e,
lachnospiraceae_bacterium	acidaminococcus_fermentans	h2o_e,
acidaminococcus_fermentans	lachnospiraceae_bacterium	ura_e,
lachnospiraceae_bacterium	acidaminococcus_fermentans	h2o_e,
acidaminococcus_fermentans	lachnospiraceae_bacterium	ura_e,
lachnospiraceae_bacterium	acidaminococcus_fermentans	h2o_e,
acidaminococcus_fermentans	lachnospiraceae_bacterium	ura_e,
lachnospiraceae_bacterium	acidaminococcus_fermentans	h2o_e,
acidaminococcus_fermentans	lachnospiraceae_bacterium	ura_e,
lachnospiraceae_bacterium	acidaminococcus_fermentans	h2o_e,
acidaminococcus_fermentans	mobilibacterium_timonense	gly_e,ade_e,
mobilibacterium_timonense	acidaminococcus_fermentans	
acidaminococcus_fermentans	ruminococcaceae_bacterium	fe2_e,
ruminococcaceae_bacterium	acidaminococcus_fermentans	ala__L_e,
acidaminococcus_timonensis	lachnospiraceae_bacterium	asp__L_e,ura_e,
lachnospiraceae_bacterium	acidaminococcus_timonensis	nh4_e,h2o_e,
acidibacillus_ferrooxidans	fusobacterium_necrophorum	h2o_e,pi_e,
fusobacterium_necrophorum	acidibacillus_ferrooxidans	succ_e,
acidibacillus_ferrooxidans	spirochaeta_thermophila	h2o_e,
spirochaeta_thermophila	acidibacillus_ferrooxidans	
acidihalobacter_prosperus	cryobacterium_arcticum	glyc_e,gthox_e,
cryobacterium_arcticum	acidihalobacter_prosperus	h2o_e,icit_e,h2o2_e,fe2_e,
acidihalobacter_prosperus	geodermatophilus_africanus	orn_e,glu__L_e,
geodermatophilus_africanus	acidihalobacter_prosperus	4abut_e,h2o_e,fe2_e,
acidimicrobium_ferrooxidans	cnuibacter_physcomitrellae	h2o_e,
cnuibacter_physcomitrellae	acidimicrobium_ferrooxidans	
acidiphilium_multivorum	aurantimonas_manganoxydans	
aurantimonas_manganoxydans	acidiphilium_multivorum	no2_e,
acidiphilium_multivorum	mycoplasma_canis	
mycoplasma_canis	acidiphilium_multivorum	h_e,
acidipropionibacterium_acidipropionici	aquincola_tertiaricarbonis	
aquincola_tertiaricarbonis	acidipropionibacterium_acidipropionici	glu__L_e,pro__L_e,
acidithiobacillus_caldus	cryobacterium_flavum	nh4_e,
cryobacterium_flavum	acidithiobacillus_caldus	
acidithrix_ferrooxidans	chitinimonas_koreensis	
chitinimonas_koreensis	acidithrix_ferrooxidans	
acidobacterium_ailaaui	sulfurihydrogenibium_azorense	gua_e,
sulfurihydrogenibium_azorense	acidobacterium_ailaaui	h2o_e,pyr_e,
acidobacterium_capsulatum	niabella_aurantiaca	h_e,orn_e,tsul_e,
niabella_aurantiaca	acidobacterium_capsulatum	
acidothermus_cellulolyticus	agrococcus_jejuensis	
agrococcus_jejuensis	acidothermus_cellulolyticus	pro__L_e,
acidovorax_avenae	haloglycomyces_albus	
haloglycomyces_albus	acidovorax_avenae	h_e,
acidovorax_caeni	dethiosulfovibrio_peptidovorans	h2s_e,
dethiosulfovibrio_peptidovorans	acidovorax_caeni	gly_e,
acidovorax_delafieldii	moraxella_boevrei	no2_e,
moraxella_boevrei	acidovorax_delafieldii	val__L_e,
acidovorax_wautersii	chloroherpeton_thalassium	
chloroherpeton_thalassium	acidovorax_wautersii	nh4_e,
acidovorax_wautersii	photobacterium_leiognathi	pi_e,
photobacterium_leiognathi	acidovorax_wautersii	
acinetobacter_bohemicus	pontibacter_lucknowensis	
pontibacter_lucknowensis	acinetobacter_bohemicus	
acinetobacter_boissieri	microbacterium_testaceum	
microbacterium_testaceum	acinetobacter_boissieri	h2o_e,
acinetobacter_kookii	candidatus_berkiella	
candidatus_berkiella	acinetobacter_kookii	
acinetobacter_kookii	halobacteriovorax_marinus	acald_e,trp__L_e,
halobacteriovorax_marinus	acinetobacter_kookii	h2o_e,h_e,pi_e,
acinetobacter_kookii	neptunomonas_antarctica	
neptunomonas_antarctica	acinetobacter_kookii	pi_e,
acinetobacter_larvae	elusimicrobium_minutum	fe2_e,
elusimicrobium_minutum	acinetobacter_larvae	
acinetobacter_nectaris	psychroserpens_mesophilus	gly_e,bz_e,
psychroserpens_mesophilus	acinetobacter_nectaris	h2o_e,h_e,
acinetobacter_nectaris	solemya_velesiana	gly_e,
solemya_velesiana	acinetobacter_nectaris	h2o_e,
acinetobacter_qingfengensis	imhoffiella_purpurea	pi_e,
imhoffiella_purpurea	acinetobacter_qingfengensis	h2o_e,
acinetobacter_schindleri	candidatus_competibacter	
candidatus_competibacter	acinetobacter_schindleri	
actibacterium_mucosum	hyphomicrobium_denitrificans	h2o_e,etoh_e,
hyphomicrobium_denitrificans	actibacterium_mucosum	h_e,hxan_e,
actinoalloteichus_hoggarensis	shimia_haliotis	cu2_e,
shimia_haliotis	actinoalloteichus_hoggarensis	
actinoalloteichus_hymeniacidonis	altererythrobacter_marensis	mal__L_e,glyclt_e,hxan_e,
altererythrobacter_marensis	actinoalloteichus_hymeniacidonis	nh4_e,
actinoalloteichus_hymeniacidonis	limnohabitans_planktonicus	
limnohabitans_planktonicus	actinoalloteichus_hymeniacidonis	acald_e,
actinobacillus_succinogenes	mannheimia_haemolytica	
mannheimia_haemolytica	actinobacillus_succinogenes	
actinobacillus_succinogenes	vibrio_ostreicida	asp__L_e,
vibrio_ostreicida	actinobacillus_succinogenes	
actinokineospora_bangkokensis	nocardioides_halotolerans	
nocardioides_halotolerans	actinokineospora_bangkokensis	
actinomadura_chibensis	delftia_acidovorans	
delftia_acidovorans	actinomadura_chibensis	
actinomadura_flavalba	exiguobacterium_sibiricum	pi_e,h_e,
exiguobacterium_sibiricum	actinomadura_flavalba	
actinomyces_liubingyangii	listeria_rocourtiae	pi_e,
listeria_rocourtiae	actinomyces_liubingyangii	
actinomyces_provencensis	kribbella_catacumbae	lac__L_e,fe3_e,cu2_e,
kribbella_catacumbae	actinomyces_provencensis	h2o_e,h2s_e,pro__L_e,
actinomyces_radicidentis	leptolyngbya_boryana	acald_e,
leptolyngbya_boryana	actinomyces_radicidentis	pi_e,fe2_e,
actinomyces_ruminicola	pseudomonas_pohangensis	nh4_e,pi_e,gly_e,
pseudomonas_pohangensis	actinomyces_ruminicola	lac__L_e,
actinomyces_vulturis	methyloceanibacter_methanicus	h2o_e,gly_e,h_e,
methyloceanibacter_methanicus	actinomyces_vulturis	pi_e,
actinophytocola_xinjiangensis	mycobacterium_koreense	h_e,
mycobacterium_koreense	actinophytocola_xinjiangensis	acald_e,
actinoplanes_friuliensis	catenulispora_acidiphila	
catenulispora_acidiphila	actinoplanes_friuliensis	h2o_e,h_e,h2s_e,
actinoplanes_missouriensis	thermosediminibacter_oceani	
thermosediminibacter_oceani	actinoplanes_missouriensis	glu__L_e,
actinopolymorpha_cephalotaxi	kribbella_catacumbae	
kribbella_catacumbae	actinopolymorpha_cephalotaxi	h2o_e,
actinopolymorpha_singaporensis	leucobacter_chromiiresistens	h_e,glu__L_e,
leucobacter_chromiiresistens	actinopolymorpha_singaporensis	
actinopolymorpha_singaporensis	paracoccus_sediminis	h_e,pi_e,cu2_e,
paracoccus_sediminis	actinopolymorpha_singaporensis	h2o_e,
actinopolyspora_xinjiangensis	brevundimonas_subvibrioides	h2o_e,
brevundimonas_subvibrioides	actinopolyspora_xinjiangensis	
actinosynnema_mirum	lactobacillus_brantae	h2o_e,
lactobacillus_brantae	actinosynnema_mirum	
actinotalea_ferrariae	bifidobacterium_crudilactis	acald_e,glu__L_e,h2s_e,
bifidobacterium_crudilactis	actinotalea_ferrariae	ade_e,
actinotignum_schaalii	oceanobacillus_damuensis	
oceanobacillus_damuensis	actinotignum_schaalii	val__L_e,
acuticoccus_yangtzensis	desulfuromonas_acetoxidans	glyc_e,
desulfuromonas_acetoxidans	acuticoccus_yangtzensis	nh4_e,gly_e,
acuticoccus_yangtzensis	gimesia_maris	
gimesia_maris	acuticoccus_yangtzensis	
adlercreutzia_equolifaciens	arabia_massiliensis	ala__L_e,
arabia_massiliensis	adlercreutzia_equolifaciens	mal__L_e,glu__L_e,
advenella_mimigardefordensis	desulfovibrio_fairfieldensis	pro__L_e,val__L_e,ura_e,
desulfovibrio_fairfieldensis	advenella_mimigardefordensis	nh4_e,gly_e,fe3_e,
aequorivita_sublithincola	occidentia_massiliensis	
occidentia_massiliensis	aequorivita_sublithincola	
aeribacillus_pallidus	loktanella_soesokkakensis	
loktanella_soesokkakensis	aeribacillus_pallidus	
aerococcus_christensenii	caloranaerobacter_ferrireducens	nh4_e,h2s_e,
caloranaerobacter_ferrireducens	aerococcus_christensenii	h2o_e,h_e,
aerococcus_urinae	marinomonas_atlantica	h2o_e,gly_e,
marinomonas_atlantica	aerococcus_urinae	nh4_e,
aerococcus_urinaeequi	pseudomonas_syringae	
pseudomonas_syringae	aerococcus_urinaeequi	
aerococcus_urinaehominis	oceaniovalibus_guishaninsula	
oceaniovalibus_guishaninsula	aerococcus_urinaehominis	
aeromicrobium_erythreum	kaistia_granuli	
kaistia_granuli	aeromicrobium_erythreum	h2s_e,
aeromicrobium_marinum	pseudarthrobacter_phenanthrenivorans	h_e,
pseudarthrobacter_phenanthrenivorans	aeromicrobium_marinum	
aeromicrobium_massiliense	gryllotalpicola_ginsengisoli	
gryllotalpicola_ginsengisoli	aeromicrobium_massiliense	pyr_e,nh4_e,
aeromicrobium_massiliense	lentzea_kentuckyensis	glu__L_e,
lentzea_kentuckyensis	aeromicrobium_massiliense	acald_e,
aeromonas_fluvialis	amantichitinum_ursilacus	
amantichitinum_ursilacus	aeromonas_fluvialis	asp__L_e,pi_e,
aeromonas_fluvialis	corynebacterium_diphtheriae	
corynebacterium_diphtheriae	aeromonas_fluvialis	asp__L_e,
aeromonas_fluvialis	nitratireductor_pacificus	glu__L_e,
nitratireductor_pacificus	aeromonas_fluvialis	
aeromonas_salmonicida	streptococcus_macacae	h2o_e,
streptococcus_macacae	aeromonas_salmonicida	nh4_e,pi_e,ade_e,ala__D_e,
aeromonas_schubertii	halotalea_alkalilenta	
halotalea_alkalilenta	aeromonas_schubertii	pi_e,asp__L_e,
aestuariibacter_aggregatus	ruminococcaceae_bacterium	fe2_e,
ruminococcaceae_bacterium	aestuariibacter_aggregatus	no2_e,ala__L_e,ade_e,
aestuariivita_atlantica	corynebacterium_phocae	h_e,
corynebacterium_phocae	aestuariivita_atlantica	
afifella_marina	campylobacter_corcagiensis	pi_e,
campylobacter_corcagiensis	afifella_marina	pyr_e,
agarivorans_gilvus	idiomarina_piscisalsi	h2s_e,
idiomarina_piscisalsi	agarivorans_gilvus	h_e,
agarivorans_gilvus	thiomicrospira_microaerophila	uri_e,
thiomicrospira_microaerophila	agarivorans_gilvus	asp__L_e,
agrobacterium_vitis	bacillus_acidiceler	
bacillus_acidiceler	agrobacterium_vitis	h2o_e,pi_e,mal__L_e,
agrobacterium_vitis	bifidobacterium_pseudolongum	orn_e,
bifidobacterium_pseudolongum	agrobacterium_vitis	
agrobacterium_vitis	chlorobaculum_parvum	no2_e,
chlorobaculum_parvum	agrobacterium_vitis	
agrobacterium_vitis	halanaerobium_praevalens	
halanaerobium_praevalens	agrobacterium_vitis	mal__L_e,
agrobacterium_vitis	magnetospirillum_magneticum	no2_e,
magnetospirillum_magneticum	agrobacterium_vitis	etoh_e,
agrobacterium_vitis	tepidanaerobacter_acetatoxydans	
tepidanaerobacter_acetatoxydans	agrobacterium_vitis	pi_e,
agrococcus_carbonis	agrococcus_lahaulensis	h2o_e,
agrococcus_lahaulensis	agrococcus_carbonis	ser__D_e,ala__L_e,pro__L_e,h2s_e,
agrococcus_carbonis	microbacterium_azadirachtae	orn_e,
microbacterium_azadirachtae	agrococcus_carbonis	ser__D_e,h2s_e,
agrococcus_casei	caldanaerovirga_acetigignens	nh4_e,
caldanaerovirga_acetigignens	agrococcus_casei	h2s_e,
agrococcus_jejuensis	anaerococcus_mediterraneensis	fe2_e,
anaerococcus_mediterraneensis	agrococcus_jejuensis	ade_e,
agrococcus_lahaulensis	fontimonas_thermophila	ala__L_e,asp__L_e,icit_e,
fontimonas_thermophila	agrococcus_lahaulensis	h_e,acald_e,
agromyces_aureus	phycicoccus_jejuensis	no2_e,cu2_e,
phycicoccus_jejuensis	agromyces_aureus	lac__L_e,
akkermansia_glycaniphila	bifidobacterium_saguini	
bifidobacterium_saguini	akkermansia_glycaniphila	nh4_e,gly_e,glu__L_e,
akkermansia_glycaniphila	paenibacillus_larvae	
paenibacillus_larvae	akkermansia_glycaniphila	glu__L_e,pi_e,
albidovulum_xiamenense	methylocella_silvestris	pi_e,fe3_e,
methylocella_silvestris	albidovulum_xiamenense	
albimonas_donghaensis	catalinimonas_alkaloidigena	acald_e,
catalinimonas_alkaloidigena	albimonas_donghaensis	h_e,no2_e,pi_e,
alcanivorax_dieselolei	mobiluncus_mulieris	pi_e,
mobiluncus_mulieris	alcanivorax_dieselolei	nh4_e,
alcanivorax_hongdengensis	variovorax_paradoxus	cu2_e,
variovorax_paradoxus	alcanivorax_hongdengensis	
alcanivorax_pacificus	pseudomonas_massiliensis	
pseudomonas_massiliensis	alcanivorax_pacificus	pyr_e,
alcanivorax_pacificus	roseomonas_gilardii	
roseomonas_gilardii	alcanivorax_pacificus	pyr_e,
algibacter_alginicilyticus	crenothrix_polyspora	h2o_e,
crenothrix_polyspora	algibacter_alginicilyticus	
algibacter_alginicilyticus	flavobacterium_johnsoniae	
flavobacterium_johnsoniae	algibacter_alginicilyticus	pyr_e,
algibacter_alginicilyticus	lactobacillus_paracollinoides	thym_e,
lactobacillus_paracollinoides	algibacter_alginicilyticus	h_e,
algibacter_alginicilyticus	sediminibacterium_ginsengisoli	h2o_e,
sediminibacterium_ginsengisoli	algibacter_alginicilyticus	
algibacter_aquaticus	amycolatopsis_marina	h_e,
amycolatopsis_marina	algibacter_aquaticus	pi_e,h2s_e,
algibacter_pectinivorans	nonlabens_spongiae	h_e,pyr_e,
nonlabens_spongiae	algibacter_pectinivorans	cgly_e,
algiphilus_aromaticivorans	pantoea_agglomerans	
pantoea_agglomerans	algiphilus_aromaticivorans	gly_e,cgly_e,
algoriella_xinjiangensis	erythrobacter_longus	
erythrobacter_longus	algoriella_xinjiangensis	h2s_e,
algoriphagus_faecimaris	schlesneria_paludicola	h2o_e,h2s_e,pro__L_e,fe2_e,
schlesneria_paludicola	algoriphagus_faecimaris	cgly_e,
algoriphagus_machipongonensis	erythrobacter_gangjinensis	glu__L_e,h2o_e,fe2_e,
erythrobacter_gangjinensis	algoriphagus_machipongonensis	gly_e,nh4_e,
algoriphagus_marinus	tenacibaculum_holothuriorum	pi_e,h2s_e,
tenacibaculum_holothuriorum	algoriphagus_marinus	h2o_e,gly_e,
algoriphagus_resistens	geobacter_uraniireducens	
geobacter_uraniireducens	algoriphagus_resistens	acald_e,
algoriphagus_terrigena	commensalibacter_intestini	h2o_e,
commensalibacter_intestini	algoriphagus_terrigena	asp__L_e,gly_e,
algoriphagus_vanfongensis	lactobacillus_composti	h_e,
lactobacillus_composti	algoriphagus_vanfongensis	ala__L_e,gly_e,fe2_e,
algoriphagus_zhangzhouensis	streptomyces_alboflavus	h_e,h2o_e,cu2_e,
streptomyces_alboflavus	algoriphagus_zhangzhouensis	
aliagarivorans_marinus	xanthomonas_citri	gly_e,asp__L_e,
xanthomonas_citri	aliagarivorans_marinus	
alicyclobacillus_acidocaldarius	alicyclobacillus_macrosporangiidus	glyclt_e,
alicyclobacillus_macrosporangiidus	alicyclobacillus_acidocaldarius	
alicyclobacillus_acidocaldarius	bacillus_kribbensis	gua_e,glyclt_e,
bacillus_kribbensis	alicyclobacillus_acidocaldarius	
alicyclobacillus_acidocaldarius	demequina_flava	4abut_e,
demequina_flava	alicyclobacillus_acidocaldarius	
alicyclobacillus_acidocaldarius	paenibacillus_bovis	glyclt_e,
paenibacillus_bovis	alicyclobacillus_acidocaldarius	h2o_e,
alicyclobacillus_acidocaldarius	paenibacillus_ihumii	glyclt_e,
paenibacillus_ihumii	alicyclobacillus_acidocaldarius	h2o_e,
alicyclobacillus_contaminans	fibrella_aestuarina	pi_e,
fibrella_aestuarina	alicyclobacillus_contaminans	
alicyclobacillus_ferrooxydans	truepera_radiovictrix	
truepera_radiovictrix	alicyclobacillus_ferrooxydans	
alicyclobacillus_kakegawensis	bacillus_selenitireducens	h2s_e,thym_e,
bacillus_selenitireducens	alicyclobacillus_kakegawensis	
alicyclobacillus_kakegawensis	paenibacillus_donghaensis	
paenibacillus_donghaensis	alicyclobacillus_kakegawensis	h2o_e,h_e,
alicyclobacillus_kakegawensis	ruminococcaceae_bacterium	acald_e,fe2_e,
ruminococcaceae_bacterium	alicyclobacillus_kakegawensis	
aliifodinibius_roseus	cobetia_crustatorum	glu__L_e,
cobetia_crustatorum	aliifodinibius_roseus	glyc_e,h2o_e,h_e,etoh_e,
aliivibrio_salmonicida	mizugakiibacter_sediminis	pyr_e,
mizugakiibacter_sediminis	aliivibrio_salmonicida	pi_e,
aliivibrio_salmonicida	photobacterium_galatheae	acald_e,
photobacterium_galatheae	aliivibrio_salmonicida	pi_e,ala__L_e,
aliivibrio_wodanis	providencia_heimbachae	
providencia_heimbachae	aliivibrio_wodanis	gly_e,
alistipes_indistinctus	peptoniphilus_coxii	gua_e,
peptoniphilus_coxii	alistipes_indistinctus	fe2_e,
alistipes_indistinctus	prevotella_multisaccharivorax	h_e,fum_e,
prevotella_multisaccharivorax	alistipes_indistinctus	h2o_e,h2s_e,fe2_e,
alistipes_inops	candidatus_kinetoplastibacterium	
candidatus_kinetoplastibacterium	alistipes_inops	
alistipes_timonensis	neisseria_wadsworthii	h_e,
neisseria_wadsworthii	alistipes_timonensis	acald_e,pi_e,
alistipes_timonensis	prevotella_buccalis	nh4_e,
prevotella_buccalis	alistipes_timonensis	
aliterella_atlantica	brevibacterium_senegalense	h2o_e,ade_e,
brevibacterium_senegalense	aliterella_atlantica	
alkalibacterium_gilvum	pseudanabaena_biceps	
pseudanabaena_biceps	alkalibacterium_gilvum	
alkalibacterium_pelagium	rubeoparvulum_massiliense	glu__L_e,
rubeoparvulum_massiliense	alkalibacterium_pelagium	h2o_e,ala__L_e,
alkalilimnicola_ehrlichii	bordetella_genomosp	
bordetella_genomosp	alkalilimnicola_ehrlichii	
alkaliphilus_oremlandii	bacillus_panaciterrae	glu__L_e,asp__L_e,acald_e,
bacillus_panaciterrae	alkaliphilus_oremlandii	h2o_e,fe2_e,
alkaliphilus_peptidifermentans	salinihabitans_flavidus	h2o_e,no2_e,etoh_e,cu2_e,
salinihabitans_flavidus	alkaliphilus_peptidifermentans	4abut_e,asp__L_e,
alkalispirochaeta_odontotermitis	thermoactinospora_rubra	pyr_e,nh4_e,
thermoactinospora_rubra	alkalispirochaeta_odontotermitis	pi_e,
alkalitalea_saponilacus	bacillus_ligniniphilus	nh4_e,
bacillus_ligniniphilus	alkalitalea_saponilacus	gly_e,
alkalitalea_saponilacus	lentibacillus_jeotgali	nh4_e,glu__L_e,pi_e,
lentibacillus_jeotgali	alkalitalea_saponilacus	glyclt_e,
alkalitalea_saponilacus	tepidicaulis_marinus	nh4_e,pi_e,cgly_e,
tepidicaulis_marinus	alkalitalea_saponilacus	
allochromatium_vinosum	amycolatopsis_saalfeldensis	
amycolatopsis_saalfeldensis	allochromatium_vinosum	h2o_e,
allofrancisella_guangzhouensis	smaragdicoccus_niigatensis	nh4_e,h2s_e,
smaragdicoccus_niigatensis	allofrancisella_guangzhouensis	pi_e,
allokutzneria_albata	candidatus_desulfovibrio	
candidatus_desulfovibrio	allokutzneria_albata	
allosalinactinospora_lopnorensis	candidatus_synechococcus	
candidatus_synechococcus	allosalinactinospora_lopnorensis	
alloscardovia_criceti	nocardia_acidivorans	
nocardia_acidivorans	alloscardovia_criceti	h2o_e,
alloscardovia_macacae	terribacillus_halophilus	
terribacillus_halophilus	alloscardovia_macacae	h2o_e,
alloscardovia_omnicolens	demequina_aestuarii	h2o_e,acald_e,arab__L_e,
demequina_aestuarii	alloscardovia_omnicolens	
altererythrobacter_atlanticus	candidatus_liberibacter	
candidatus_liberibacter	altererythrobacter_atlanticus	
altererythrobacter_atlanticus	halomonas_gudaonensis	
halomonas_gudaonensis	altererythrobacter_atlanticus	pi_e,
altererythrobacter_dongtanensis	caldicoprobacter_oshimai	pi_e,
caldicoprobacter_oshimai	altererythrobacter_dongtanensis	icit_e,
altererythrobacter_dongtanensis	methylibium_petroleiphilum	for_e,pi_e,fe2_e,
methylibium_petroleiphilum	altererythrobacter_dongtanensis	h2s_e,pro__L_e,cu2_e,
altererythrobacter_dongtanensis	roseovarius_pacificus	orn_e,pi_e,
roseovarius_pacificus	altererythrobacter_dongtanensis	h2s_e,cu2_e,
altererythrobacter_epoxidivorans	nautilia_profundicola	h2o_e,acald_e,pro__L_e,fe2_e,
nautilia_profundicola	altererythrobacter_epoxidivorans	orn_e,
altererythrobacter_ishigakiensis	burkholderia_gladioli	acald_e,pyr_e,
burkholderia_gladioli	altererythrobacter_ishigakiensis	
altererythrobacter_namhicola	aureimonas_altamirensis	
aureimonas_altamirensis	altererythrobacter_namhicola	ala__L_e,gly_e,
alteribacillus_bidgolensis	chryseobacterium_soldanellicola	
chryseobacterium_soldanellicola	alteribacillus_bidgolensis	h2s_e,
alteribacillus_bidgolensis	mycobacterium_arosiense	
mycobacterium_arosiense	alteribacillus_bidgolensis	glyc_e,h2s_e,
alteribacillus_bidgolensis	pseudomonas_psychrotolerans	pi_e,
pseudomonas_psychrotolerans	alteribacillus_bidgolensis	h2s_e,
alteribacillus_persepolensis	mycetocola_miduiensis	gly_e,
mycetocola_miduiensis	alteribacillus_persepolensis	nh4_e,
alteromonas_australica	rheinheimera_salexigens	
rheinheimera_salexigens	alteromonas_australica	pyr_e,h2_e,
altibacter_lentus	bosea_lupini	pi_e,pro__L_e,
bosea_lupini	altibacter_lentus	no2_e,glyc_e,bz_e,
aminobacter_aminovorans	bacillus_glycinifermentans	acald_e,
bacillus_glycinifermentans	aminobacter_aminovorans	
aminobacterium_colombiense	devosia_enhydra	pi_e,gua_e,
devosia_enhydra	aminobacterium_colombiense	
ammonifex_degensii	desulfatirhabdium_butyrativorans	gua_e,
desulfatirhabdium_butyrativorans	ammonifex_degensii	
ammonifex_degensii	desulfoluna_spongiiphila	
desulfoluna_spongiiphila	ammonifex_degensii	
ammonifex_degensii	gloeobacter_violaceus	glu__L_e,
gloeobacter_violaceus	ammonifex_degensii	glyald_e,
ammonifex_degensii	murdochiella_massiliensis	glu__L_e,acald_e,
murdochiella_massiliensis	ammonifex_degensii	h_e,akg_e,
ammonifex_degensii	paenibacillus_gorillae	
paenibacillus_gorillae	ammonifex_degensii	h_e,
ammonifex_degensii	pseudodesulfovibrio_indicus	fum_e,acald_e,
pseudodesulfovibrio_indicus	ammonifex_degensii	akg_e,glyclt_e,
amorphus_coralli	lactobacillus_mixtipabuli	nh4_e,
lactobacillus_mixtipabuli	amorphus_coralli	h_e,gly_e,
amphibacillus_sediminis	paenibacillus_catalpae	pi_e,h2s_e,
paenibacillus_catalpae	amphibacillus_sediminis	
amphibacillus_sediminis	thermobacillus_composti	pi_e,h2s_e,
thermobacillus_composti	amphibacillus_sediminis	h2o_e,
amphiplicatus_metriothermophilus	salinimicrobium_terrae	
salinimicrobium_terrae	amphiplicatus_metriothermophilus	
amphritea_japonica	microbulbifer_thermotolerans	pi_e,cu2_e,
microbulbifer_thermotolerans	amphritea_japonica	nh4_e,
amycolatopsis_australiensis	cyanobium_gracile	h2o_e,h_e,
cyanobium_gracile	amycolatopsis_australiensis	
amycolatopsis_australiensis	rubrobacter_xylanophilus	h2s_e,h_e,
rubrobacter_xylanophilus	amycolatopsis_australiensis	
amycolatopsis_australiensis	sphingomonas_mucosissima	h2o_e,h_e,fe3_e,cu2_e,
sphingomonas_mucosissima	amycolatopsis_australiensis	acald_e,nh4_e,
amycolatopsis_benzoatilytica	deinococcus_radiodurans	h_e,
deinococcus_radiodurans	amycolatopsis_benzoatilytica	glu__L_e,nh4_e,lac__L_e,
amycolatopsis_halophila	candidatus_planktophila	
candidatus_planktophila	amycolatopsis_halophila	
amycolatopsis_halophila	microbacterium_pygmaeum	nh4_e,h2s_e,
microbacterium_pygmaeum	amycolatopsis_halophila	
amycolatopsis_halophila	pseudoxanthomonas_suwonensis	nh4_e,pi_e,
pseudoxanthomonas_suwonensis	amycolatopsis_halophila	
amycolatopsis_halophila	salinicoccus_luteus	
salinicoccus_luteus	amycolatopsis_halophila	
amycolatopsis_halophila	sanguibacter_gelidistatuariae	nh4_e,
sanguibacter_gelidistatuariae	amycolatopsis_halophila	
amycolatopsis_jejuensis	deinococcus_misasensis	h2o_e,
deinococcus_misasensis	amycolatopsis_jejuensis	h_e,
amycolatopsis_marina	candidatus_pelagibacter	
candidatus_pelagibacter	amycolatopsis_marina	
amycolatopsis_mediterranei	lactobacillus_similis	
lactobacillus_similis	amycolatopsis_mediterranei	glu__L_e,
amycolatopsis_nigrescens	pelagirhabdus_alkalitolerans	
pelagirhabdus_alkalitolerans	amycolatopsis_nigrescens	
amycolatopsis_nigrescens	tessaracoccus_massiliensis	asp__L_e,
tessaracoccus_massiliensis	amycolatopsis_nigrescens	
amycolatopsis_saalfeldensis	gloeobacter_kilaueensis	
gloeobacter_kilaueensis	amycolatopsis_saalfeldensis	
amycolatopsis_saalfeldensis	thermus_arciformis	
thermus_arciformis	amycolatopsis_saalfeldensis	glyclt_e,nh4_e,
amycolatopsis_taiwanensis	terracidiphilus_gabretensis	
terracidiphilus_gabretensis	amycolatopsis_taiwanensis	
anaerococcus_prevotii	desulfovibrio_fairfieldensis	h2o_e,pi_e,ala__L_e,val__L_e,pro__L_e,glu__L_e,
desulfovibrio_fairfieldensis	anaerococcus_prevotii	orn_e,nh4_e,asp__L_e,
anaerococcus_provencensis	dialister_micraerophilus	h_e,pi_e,trp__L_e,
dialister_micraerophilus	anaerococcus_provencensis	
anaerolinea_thermophila	kyrpidia_tusciae	h_e,h2s_e,
kyrpidia_tusciae	anaerolinea_thermophila	
anaeromassilibacillus_senegalensis	beduini_massiliensis	nh4_e,mal__L_e,
beduini_massiliensis	anaeromassilibacillus_senegalensis	h2o_e,
anaeromassilibacillus_senegalensis	clostridiisalibacter_paucivorans	
clostridiisalibacter_paucivorans	anaeromassilibacillus_senegalensis	
anaeromassilibacillus_senegalensis	clostridium_tepidiprofundi	nh4_e,
clostridium_tepidiprofundi	anaeromassilibacillus_senegalensis	acald_e,h2o_e,glc__D_e,
anaeromassilibacillus_senegalensis	geosporobacter_ferrireducens	nh4_e,
geosporobacter_ferrireducens	anaeromassilibacillus_senegalensis	acald_e,
anaeromassilibacillus_senegalensis	lachnospiraceae_bacterium	
lachnospiraceae_bacterium	anaeromassilibacillus_senegalensis	h2o_e,val__L_e,
anaeromyxobacter_dehalogenans	roseomonas_cervicalis	h2o_e,pyr_e,
roseomonas_cervicalis	anaeromyxobacter_dehalogenans	asp__L_e,
anaerosalibacter_massiliensis	anaerosporomusa_subterranea	h2o_e,
anaerosporomusa_subterranea	anaerosalibacter_massiliensis	pro__L_e,ade_e,fe2_e,
anaerosalibacter_massiliensis	pelobacter_carbinolicus	acald_e,
pelobacter_carbinolicus	anaerosalibacter_massiliensis	h_e,pro__L_e,
anaerosphaera_aminiphila	fervidicella_metallireducens	asp__L_e,acald_e,
fervidicella_metallireducens	anaerosphaera_aminiphila	glu__L_e,
anaerosphaera_aminiphila	lutibacter_oricola	h_e,h2o_e,asp__L_e,pi_e,
lutibacter_oricola	anaerosphaera_aminiphila	glu__L_e,
anaerosphaera_aminiphila	methyloglobulus_morosus	h_e,h2o_e,succ_e,
methyloglobulus_morosus	anaerosphaera_aminiphila	glu__L_e,
anaerovirgula_multivorans	bordetella_genomosp	
bordetella_genomosp	anaerovirgula_multivorans	
anaplasma_marginale	idiomarina_loihiensis	h_e,h2o_e,ala__L_e,pi_e,
idiomarina_loihiensis	anaplasma_marginale	glu__L_e,no2_e,
anditalea_andensis	pedobacter_cryoconitis	glu__L_e,h_e,
pedobacter_cryoconitis	anditalea_andensis	pi_e,
andreprevotia_chitinilytica	bordetella_genomosp	
bordetella_genomosp	andreprevotia_chitinilytica	
andreprevotia_chitinilytica	fusobacterium_ulcerans	
fusobacterium_ulcerans	andreprevotia_chitinilytica	asp__L_e,succ_e,
andreprevotia_chitinilytica	lysobacter_spongiicola	phe__L_e,
lysobacter_spongiicola	andreprevotia_chitinilytica	
andreprevotia_lacus	halobacillus_hunanensis	glyclt_e,succ_e,
halobacillus_hunanensis	andreprevotia_lacus	akg_e,pi_e,
aneurinibacillus_tyrosinisolvens	candidatus_promineofilum	
candidatus_promineofilum	aneurinibacillus_tyrosinisolvens	
aneurinibacillus_tyrosinisolvens	leptolyngbya_ohadii	
leptolyngbya_ohadii	aneurinibacillus_tyrosinisolvens	h_e,gua_e,ade_e,
aneurinibacillus_tyrosinisolvens	sediminispirochaeta_smaragdinae	pi_e,pro__L_e,
sediminispirochaeta_smaragdinae	aneurinibacillus_tyrosinisolvens	h_e,gua_e,ade_e,
anoxybacillus_amylolyticus	vibrio_tasmaniensis	ura_e,pi_e,
vibrio_tasmaniensis	anoxybacillus_amylolyticus	fum_e,
anoxybacillus_gonensis	fluviicola_taffensis	asp__L_e,
fluviicola_taffensis	anoxybacillus_gonensis	for_e,
antarctobacter_heliothermus	pseudomonas_saudiphocaensis	ala__L_e,nh4_e,pi_e,fe2_e,
pseudomonas_saudiphocaensis	antarctobacter_heliothermus	
apibacter_mensalis	ekhidna_lutea	asp__L_e,gly_e,
ekhidna_lutea	apibacter_mensalis	pi_e,nh4_e,
aquamicrobium_aerolatum	pelagibacterium_luteolum	h2o_e,
pelagibacterium_luteolum	aquamicrobium_aerolatum	glu__L_e,pi_e,fe2_e,
aquaspirillum_serpens	mobiluncus_curtisii	nh4_e,orn_e,
mobiluncus_curtisii	aquaspirillum_serpens	h2o_e,h_e,fe2_e,
aquiflexum_balticum	candidatus_phytoplasma	
candidatus_phytoplasma	aquiflexum_balticum	
aquiflexum_balticum	muricauda_zhangzhouensis	
muricauda_zhangzhouensis	aquiflexum_balticum	pro__L_e,pi_e,
aquimarina_amphilecti	campylobacter_sputorum	h2o_e,h_e,pyr_e,pi_e,h2s_e,
campylobacter_sputorum	aquimarina_amphilecti	nh4_e,
aquimarina_amphilecti	morganella_morganii	h2o_e,h_e,pi_e,
morganella_morganii	aquimarina_amphilecti	gly_e,
aquimarina_latercula	maricaulis_maris	no2_e,h2o_e,pi_e,
maricaulis_maris	aquimarina_latercula	acald_e,pyr_e,
aquimarina_longa	gilvimarinus_chinensis	
gilvimarinus_chinensis	aquimarina_longa	
aquimarina_macrocephali	gordonia_kroppenstedtii	pi_e,
gordonia_kroppenstedtii	aquimarina_macrocephali	h_e,
aquimarina_pacifica	nitrosomonas_ureae	nh4_e,
nitrosomonas_ureae	aquimarina_pacifica	
aquimarina_spongiae	belliella_pelovolcani	h2o_e,nh4_e,pi_e,
belliella_pelovolcani	aquimarina_spongiae	no2_e,hxan_e,h2s_e,
aquimarina_spongiae	halomicronema_hongdechloris	h2o_e,nh4_e,
halomicronema_hongdechloris	aquimarina_spongiae	ala__L_e,
aquimixticola_soesokkakensis	deinococcus_swuensis	
deinococcus_swuensis	aquimixticola_soesokkakensis	h_e,h2s_e,
arachidicoccus_rhizosphaerae	marinobacter_mobilis	pi_e,for_e,fe3_e,
marinobacter_mobilis	arachidicoccus_rhizosphaerae	etoh_e,
arachidicoccus_rhizosphaerae	roseiflexus_castenholzii	pi_e,
roseiflexus_castenholzii	arachidicoccus_rhizosphaerae	
arcanobacterium_phocae	marinobacter_psychrophilus	ala__L_e,
marinobacter_psychrophilus	arcanobacterium_phocae	pi_e,
archangium_gephyra	dehalogenimonas_lykanthroporepellens	so3_e,
dehalogenimonas_lykanthroporepellens	archangium_gephyra	h2s_e,
arcobacter_anaerophilus	defluviitoga_tunisiensis	acald_e,
defluviitoga_tunisiensis	arcobacter_anaerophilus	nh4_e,pi_e,
arcobacter_anaerophilus	tropicibacter_naphthalenivorans	
tropicibacter_naphthalenivorans	arcobacter_anaerophilus	
arcobacter_butzleri	dietzia_timorensis	h_e,
dietzia_timorensis	arcobacter_butzleri	
arcobacter_lekithochrous	enterobacter_cloacae	
enterobacter_cloacae	arcobacter_lekithochrous	
arcobacter_thereius	nocardioides_exalbidus	
nocardioides_exalbidus	arcobacter_thereius	pi_e,h2s_e,fe2_e,
arcticibacter_svalbardensis	leptospira_biflexa	pi_e,
leptospira_biflexa	arcticibacter_svalbardensis	h_e,for_e,
ardenticatena_maritima	thermogemmatispora_carboxidivorans	
thermogemmatispora_carboxidivorans	ardenticatena_maritima	pi_e,fe2_e,
arenibacter_algicola	calderihabitans_maritimus	
calderihabitans_maritimus	arenibacter_algicola	asp__L_e,
arenimonas_donghaensis	candidatus_babela	
candidatus_babela	arenimonas_donghaensis	
arenimonas_malthae	thiomonas_intermedia	
thiomonas_intermedia	arenimonas_malthae	
arenimonas_metalli	streptococcus_uberis	
streptococcus_uberis	arenimonas_metalli	nh4_e,gly_e,
arenimonas_oryziterrae	maribius_pelagius	cytd_e,
maribius_pelagius	arenimonas_oryziterrae	no2_e,nh4_e,
arenitalea_lutea	thermus_oshimai	h2o_e,h_e,pyr_e,pi_e,
thermus_oshimai	arenitalea_lutea	nh4_e,acald_e,
aromatoleum_aromaticum	chondromyces_apiculatus	h_e,
chondromyces_apiculatus	aromatoleum_aromaticum	
arsenicibacter_rosenii	mucilaginibacter_polytrichastri	mal__L_e,xtsn_e,h2s_e,
mucilaginibacter_polytrichastri	arsenicibacter_rosenii	
arsenophonus_endosymbiont	bacterium_symbiont	
bacterium_symbiont	arsenophonus_endosymbiont	
arsenophonus_endosymbiont	candidatus_carsonella	
candidatus_carsonella	arsenophonus_endosymbiont	
arsenophonus_symbiont	enterobacter_cloacae	
enterobacter_cloacae	arsenophonus_symbiont	
arthrobacter_alpinus	lactobacillus_wasatchensis	
lactobacillus_wasatchensis	arthrobacter_alpinus	acald_e,pi_e,ser__L_e,gly_e,
arthrobacter_cupressi	thermobaculum_terrenum	h2s_e,fe2_e,
thermobaculum_terrenum	arthrobacter_cupressi	nh4_e,
arthrobacter_enclensis	deinococcus_geothermalis	fe2_e,
deinococcus_geothermalis	arthrobacter_enclensis	h_e,
arthrobacter_nitrophenolicus	corynebacterium_nuruki	
corynebacterium_nuruki	arthrobacter_nitrophenolicus	ala__L_e,fum_e,acald_e,
arthrobacter_nitrophenolicus	knoellia_aerolata	
knoellia_aerolata	arthrobacter_nitrophenolicus	h_e,
arthrobacter_nitrophenolicus	thalassospira_profundimaris	pi_e,
thalassospira_profundimaris	arthrobacter_nitrophenolicus	lac__L_e,h2o_e,
asaia_astilbis	roseovarius_lutimaris	fe3_e,
roseovarius_lutimaris	asaia_astilbis	h2o_e,pi_e,
aster_yellows	enterobacter_cloacae	
enterobacter_cloacae	aster_yellows	
atopobium_deltae	thermoanaerobacterium_thermosaccharolyticum	h_e,pi_e,ura_e,
thermoanaerobacterium_thermosaccharolyticum	atopobium_deltae	phe__L_e,
auraticoccus_monumenti	aureimonas_ureilytica	cu2_e,
aureimonas_ureilytica	auraticoccus_monumenti	h2o_e,h2s_e,
auraticoccus_monumenti	chryseobacterium_haifense	
chryseobacterium_haifense	auraticoccus_monumenti	acald_e,pi_e,h2s_e,
auraticoccus_monumenti	streptomyces_puniciscabiei	ade_e,
streptomyces_puniciscabiei	auraticoccus_monumenti	cgly_e,
aureimonas_frigidaquae	desulfobacter_postgatei	h2s_e,
desulfobacter_postgatei	aureimonas_frigidaquae	h2o_e,
aureimonas_jatrophae	brevefilum_fermentans	h2s_e,4abz_e,
brevefilum_fermentans	aureimonas_jatrophae	
aureimonas_phyllosphaerae	demequina_salsinemoris	
demequina_salsinemoris	aureimonas_phyllosphaerae	pi_e,
aureimonas_phyllosphaerae	domibacillus_tundrae	
domibacillus_tundrae	aureimonas_phyllosphaerae	h2o_e,pi_e,
azohydromonas_australica	thermovenabulum_gondwanense	
thermovenabulum_gondwanense	azohydromonas_australica	
azonexus_hydrophilus	gemmatimonas_aurantiaca	h_e,fe3_e,
gemmatimonas_aurantiaca	azonexus_hydrophilus	
azorhizobium_caulinodans	planomicrobium_flavidum	gua_e,
planomicrobium_flavidum	azorhizobium_caulinodans	nh4_e,cu2_e,
azospirillum_humicireducens	filimonas_lacunae	h2o_e,
filimonas_lacunae	azospirillum_humicireducens	h_e,cu2_e,
azospirillum_lipoferum	syntrophobotulus_glycolicus	acald_e,fe2_e,
syntrophobotulus_glycolicus	azospirillum_lipoferum	fe3_e,
azospirillum_lipoferum	vibrio_genomosp	
vibrio_genomosp	azospirillum_lipoferum	
azospirillum_thiophilum	loktanella_koreensis	pi_e,glu__L_e,
loktanella_koreensis	azospirillum_thiophilum	h2o_e,nh4_e,fe3_e,
azotobacter_chroococcum	rhizobium_arenae	h_e,
rhizobium_arenae	azotobacter_chroococcum	no2_e,
azotobacter_chroococcum	uncultured_human	
uncultured_human	azotobacter_chroococcum	
azotobacter_vinelandii	intrasporangium_oryzae	acald_e,
intrasporangium_oryzae	azotobacter_vinelandii	
bacillus_acidiproducens	bittarella_massiliensis	acald_e,lac__L_e,h2o_e,
bittarella_massiliensis	bacillus_acidiproducens	nh4_e,no2_e,pi_e,val__L_e,cu2_e,
bacillus_acidiproducens	butyrivibrio_proteoclasticus	h2o_e,
butyrivibrio_proteoclasticus	bacillus_acidiproducens	cu2_e,
bacillus_acidiproducens	christensenella_massiliensis	acald_e,h2o_e,
christensenella_massiliensis	bacillus_acidiproducens	fum_e,nh4_e,no2_e,glu__L_e,pro__L_e,cu2_e,
bacillus_acidiproducens	clostridium_cellulolyticum	lac__L_e,fe2_e,
clostridium_cellulolyticum	bacillus_acidiproducens	fum_e,no2_e,pro__L_e,cu2_e,
bacillus_acidiproducens	lachnospiraceae_bacterium	acald_e,
lachnospiraceae_bacterium	bacillus_acidiproducens	nh4_e,fum_e,no2_e,val__L_e,pro__L_e,cu2_e,
bacillus_acidiproducens	lachnospiraceae_bacterium	acald_e,
lachnospiraceae_bacterium	bacillus_acidiproducens	nh4_e,fum_e,no2_e,val__L_e,pro__L_e,cu2_e,
bacillus_acidiproducens	lachnospiraceae_bacterium	acald_e,
lachnospiraceae_bacterium	bacillus_acidiproducens	nh4_e,fum_e,no2_e,val__L_e,pro__L_e,cu2_e,
bacillus_acidiproducens	lachnospiraceae_bacterium	acald_e,
lachnospiraceae_bacterium	bacillus_acidiproducens	nh4_e,fum_e,no2_e,val__L_e,pro__L_e,cu2_e,
bacillus_acidiproducens	neofamilia_massiliensis	acald_e,h2o_e,
neofamilia_massiliensis	bacillus_acidiproducens	no2_e,val__L_e,ala__D_e,glu__L_e,cu2_e,succ_e,
bacillus_acidiproducens	olsenella_scatoligenes	acald_e,fe2_e,
olsenella_scatoligenes	bacillus_acidiproducens	fum_e,glu__L_e,cu2_e,
bacillus_acidiproducens	paenibacillus_antibioticophila	trp__L_e,
paenibacillus_antibioticophila	bacillus_acidiproducens	glu__L_e,no2_e,icit_e,cu2_e,
bacillus_acidiproducens	phocea_massiliensis	acald_e,h2o_e,trp__L_e,fe2_e,
phocea_massiliensis	bacillus_acidiproducens	no2_e,val__L_e,cu2_e,
bacillus_acidiproducens	ruminococcaceae_bacterium	acald_e,h2o_e,fe2_e,
ruminococcaceae_bacterium	bacillus_acidiproducens	no2_e,pro__L_e,cu2_e,
bacillus_acidiproducens	sellimonas_intestinalis	acald_e,gly_e,h2s_e,fe2_e,
sellimonas_intestinalis	bacillus_acidiproducens	glu__L_e,pi_e,cu2_e,
bacillus_aidingensis	caenibacillus_caldisaponilyticus	
caenibacillus_caldisaponilyticus	bacillus_aidingensis	lac__L_e,h_e,h_e,h2o_e,
bacillus_aidingensis	edaphobacter_aggregans	no2_e,no2_e,pi_e,ser__L_e,
edaphobacter_aggregans	bacillus_aidingensis	h2o_e,
bacillus_aidingensis	syntrophaceticus_schinkii	pro__L_e,fe2_e,pro__L_e,fe2_e,bz_e,
syntrophaceticus_schinkii	bacillus_aidingensis	h2o_e,
bacillus_andreraoultii	gracilibacillus_ureilyticus	h_e,h2s_e,
gracilibacillus_ureilyticus	bacillus_andreraoultii	pi_e,
bacillus_atrophaeus	planktomarina_temperata	h_e,gly_e,
planktomarina_temperata	bacillus_atrophaeus	nh4_e,
bacillus_beveridgei	desulfovibrio_frigidus	btd_RR_e,
desulfovibrio_frigidus	bacillus_beveridgei	no2_e,
bacillus_campisalis	streptococcus_ratti	
streptococcus_ratti	bacillus_campisalis	h2o_e,ser__L_e,succ_e,
bacillus_caseinilyticus	didymococcus_colitermitum	
didymococcus_colitermitum	bacillus_caseinilyticus	nh4_e,
bacillus_caseinilyticus	thalassobius_maritimus	
thalassobius_maritimus	bacillus_caseinilyticus	pi_e,
bacillus_cecembensis	treponema_bryantii	
treponema_bryantii	bacillus_cecembensis	
bacillus_cellulosilyticus	gracilibacillus_ureilyticus	
gracilibacillus_ureilyticus	bacillus_cellulosilyticus	acald_e,
bacillus_cihuensis	streptobacillus_felis	h_e,gthox_e,
streptobacillus_felis	bacillus_cihuensis	h2o_e,h2o2_e,val__L_e,
bacillus_circulans	bordetella_trematum	h2o_e,h_e,lac__L_e,pi_e,
bordetella_trematum	bacillus_circulans	acald_e,
bacillus_coagulans	heliobacterium_modesticaldum	h2s_e,
heliobacterium_modesticaldum	bacillus_coagulans	pi_e,fe3_e,no2_e,cu2_e,
bacillus_cohnii	bifidobacterium_choerinum	no2_e,
bifidobacterium_choerinum	bacillus_cohnii	nh4_e,
bacillus_cohnii	flavobacterium_terrigena	pyr_e,glu__L_e,pro__L_e,uri_e,
flavobacterium_terrigena	bacillus_cohnii	
bacillus_dakarensis	desulfosporosinus_acidiphilus	pro__L_e,h2s_e,pro__L_e,glu__L_e,
desulfosporosinus_acidiphilus	bacillus_dakarensis	h2o_e,glyclt_e,h_e,trp__L_e,
bacillus_daliensis	salinispira_pacifica	
salinispira_pacifica	bacillus_daliensis	h_e,pi_e,
bacillus_dielmoensis	brachymonas_chironomi	h2o_e,gly_e,
brachymonas_chironomi	bacillus_dielmoensis	nh4_e,pi_e,
bacillus_dielmoensis	pustulibacterium_marinum	gly_e,
pustulibacterium_marinum	bacillus_dielmoensis	pi_e,
bacillus_dielmoensis	salinimicrobium_catena	gly_e,
salinimicrobium_catena	bacillus_dielmoensis	h_e,pi_e,
bacillus_enclensis	indibacter_alkaliphilus	acald_e,no2_e,pi_e,cgly_e,no2_e,acald_e,gly_e,cgly_e,
indibacter_alkaliphilus	bacillus_enclensis	ala__L_e,ala__L_e,ala__L_e,h2s_e,
bacillus_ginsengihumi	bacillus_mycoides	pi_e,h_e,
bacillus_mycoides	bacillus_ginsengihumi	asp__L_e,cu2_e,
bacillus_ginsengihumi	cellulophaga_tyrosinoxydans	h2o_e,gly_e,h2o_e,h_e,
cellulophaga_tyrosinoxydans	bacillus_ginsengihumi	no2_e,glcur_e,pi_e,h2s_e,ala__D_e,cu2_e,
bacillus_gobiensis	bacillus_shacheensis	pro__L_e,
bacillus_shacheensis	bacillus_gobiensis	pi_e,
bacillus_halosaccharovorans	unicellular_cyanobacterium	acald_e,acald_e,h2o_e,h_e,h_e,gly_e,for_e,
unicellular_cyanobacterium	bacillus_halosaccharovorans	nh4_e,pi_e,nh4_e,pi_e,
bacillus_horikoshii	pedobacter_insulae	pi_e,
pedobacter_insulae	bacillus_horikoshii	h2s_e,
bacillus_korlensis	candidatus_planktophila	
candidatus_planktophila	bacillus_korlensis	
bacillus_krulwichiae	riemerella_anatipestifer	acald_e,mal__L_e,fe2_e,
riemerella_anatipestifer	bacillus_krulwichiae	
bacillus_lonarensis	siphonobacter_aquaeclarae	asp__L_e,
siphonobacter_aquaeclarae	bacillus_lonarensis	h2o_e,pi_e,ade_e,
bacillus_massiliogorillae	marinifilum_fragile	pi_e,
marinifilum_fragile	bacillus_massiliogorillae	nh4_e,fe3_e,
bacillus_massiliosenegalensis	vulcanibacillus_modesticaldus	acald_e,lac__L_e,trp__L_e,
vulcanibacillus_modesticaldus	bacillus_massiliosenegalensis	pi_e,
bacillus_mycoides	piscibacillus_halophilus	
piscibacillus_halophilus	bacillus_mycoides	pi_e,
bacillus_niameyensis	bartonella_tamiae	mal__L_e,
bartonella_tamiae	bacillus_niameyensis	nh4_e,pi_e,
bacillus_oryziterrae	geobacter_uraniireducens	pyr_e,mal__L_e,
geobacter_uraniireducens	bacillus_oryziterrae	no2_e,asp__L_e,glyclt_e,pro__L_e,
bacillus_persicus	thermovirga_lienii	h2o_e,h2o_e,
thermovirga_lienii	bacillus_persicus	ala__L_e,ala__L_e,gly_e,xan_e,
bacillus_pseudofirmus	maribacter_forsetii	h_e,asp__L_e,gly_e,
maribacter_forsetii	bacillus_pseudofirmus	
bacillus_rubiinfantis	erwinia_iniecta	h2o_e,h_e,glyclt_e,
erwinia_iniecta	bacillus_rubiinfantis	asp__L_e,
bacillus_salsus	numidum_massiliense	h2o_e,mal__L_e,
numidum_massiliense	bacillus_salsus	
bacillus_salsus	syntrophomonas_wolfei	h2o_e,pi_e,
syntrophomonas_wolfei	bacillus_salsus	
bacillus_simplex	lactobacillus_pasteurii	mal__L_e,trp__L_e,
lactobacillus_pasteurii	bacillus_simplex	nh4_e,asp__L_e,val__L_e,
bacillus_smithii	mannheimia_succiniciproducens	h2o_e,
mannheimia_succiniciproducens	bacillus_smithii	trp__L_e,
bacillus_solimangrovi	dethiosulfatarculus_sandiegensis	glu__L_e,h2s_e,indole_e,pi_e,
dethiosulfatarculus_sandiegensis	bacillus_solimangrovi	no2_e,pro__L_e,
bacillus_testis	caecibacter_massiliensis	h_e,pi_e,fe2_e,
caecibacter_massiliensis	bacillus_testis	no2_e,
bacillus_timonensis	candidatus_kuenenia	
candidatus_kuenenia	bacillus_timonensis	
bacillus_tuaregi	planococcus_antarcticus	pi_e,gua_e,nh4_e,acald_e,h_e,
planococcus_antarcticus	bacillus_tuaregi	glu__L_e,
bacillus_weihaiensis	ectothiorhodospira_marina	pi_e,for_e,
ectothiorhodospira_marina	bacillus_weihaiensis	
bacillus_weihaiensis	sphingobium_ummariense	pi_e,
sphingobium_ummariense	bacillus_weihaiensis	h_e,
bacillus_xerothermodurans	desnuesiella_massiliensis	pi_e,
desnuesiella_massiliensis	bacillus_xerothermodurans	acald_e,
bacterium_endosymbiont	candidatus_blochmannia	
candidatus_blochmannia	bacterium_endosymbiont	
bacterium_endosymbiont	thermoflexus_hugenholtzii	succ_e,h_e,
thermoflexus_hugenholtzii	bacterium_endosymbiont	nh4_e,no2_e,
bacterium_symbiont	shewanella_pealeana	
shewanella_pealeana	bacterium_symbiont	
bacteroides_coprosuis	barnesiella_viscericola	h2o_e,pi_e,
barnesiella_viscericola	bacteroides_coprosuis	h_e,
bacteroides_coprosuis	psychromonas_ossibalaenae	pi_e,ala__L_e,
psychromonas_ossibalaenae	bacteroides_coprosuis	acald_e,
bacteroides_coprosuis	sutterella_parvirubra	orn_e,
sutterella_parvirubra	bacteroides_coprosuis	acald_e,gly_e,
bacteroides_graminisolvens	lachnospiraceae_bacterium	
lachnospiraceae_bacterium	bacteroides_graminisolvens	h2o_e,gly_e,
bacteroides_graminisolvens	libanicoccus_massiliensis	nh4_e,orn_e,fe2_e,
libanicoccus_massiliensis	bacteroides_graminisolvens	h2o_e,acald_e,
bacteroides_graminisolvens	neglecta_timonensis	fe2_e,
neglecta_timonensis	bacteroides_graminisolvens	gly_e,ura_e,
bacteroides_ihuae	isoptericola_variabilis	nh4_e,
isoptericola_variabilis	bacteroides_ihuae	ala__L_e,
bacteroides_neonati	ruminiclostridium_thermocellum	
ruminiclostridium_thermocellum	bacteroides_neonati	pi_e,succ_e,
bacteroides_propionicifaciens	tangfeifania_diversioriginum	nh4_e,ser__D_e,gly_e,h2s_e,
tangfeifania_diversioriginum	bacteroides_propionicifaciens	
bacteroides_pyogenes	prevotella_bivia	
prevotella_bivia	bacteroides_pyogenes	
bartonella_florencae	cruoricaptor_ignavus	
cruoricaptor_ignavus	bartonella_florencae	
bartonella_quintana	rhodococcus_erythropolis	nh4_e,co2_e,
rhodococcus_erythropolis	bartonella_quintana	akg_e,pi_e,gly_e,fe2_e,
bartonella_tamiae	calditerrivibrio_nitroreducens	nh4_e,fe2_e,
calditerrivibrio_nitroreducens	bartonella_tamiae	ala__L_e,
bauldia_litoralis	flavobacterium_caeni	
flavobacterium_caeni	bauldia_litoralis	glu__L_e,
bauldia_litoralis	mycobacterium_celeriflavum	
mycobacterium_celeriflavum	bauldia_litoralis	
bavariicoccus_seileri	secondary_endosymbiont	leu__L_e,
secondary_endosymbiont	bavariicoccus_seileri	h_e,nh4_e,h2o_e,h_e,h2s_e,succ_e,
bdellovibrio_exovorus	flaviramulus_ichthyoenteri	
flaviramulus_ichthyoenteri	bdellovibrio_exovorus	h2o_e,fe2_e,
beijerinckia_indica	geodermatophilus_nigrescens	h2s_e,
geodermatophilus_nigrescens	beijerinckia_indica	h2o_e,mal__L_e,fe3_e,cu2_e,
belliella_baltica	lactobacillus_similis	h2o_e,
lactobacillus_similis	belliella_baltica	asp__L_e,gly_e,
bellilinea_caldifistulae	oligotropha_carboxidovorans	
oligotropha_carboxidovorans	bellilinea_caldifistulae	pi_e,h2s_e,
belnapia_moabensis	rhodothermus_profundi	ade_e,
rhodothermus_profundi	belnapia_moabensis	nh4_e,pi_e,
belnapia_moabensis	thermus_brockianus	
thermus_brockianus	belnapia_moabensis	nh4_e,
belnapia_rosea	granulicella_rosea	acald_e,ade_e,h2s_e,
granulicella_rosea	belnapia_rosea	
bergeyella_zoohelcum	enterobacter_cloacae	
enterobacter_cloacae	bergeyella_zoohelcum	
bernardetia_litoralis	derxia_lacustris	glu__L_e,cu2_e,
derxia_lacustris	bernardetia_litoralis	met__L_e,
beutenbergia_cavernae	xylanimonas_cellulosilytica	h2o_e,
xylanimonas_cellulosilytica	beutenbergia_cavernae	h_e,no2_e,pi_e,orn_e,
bhargavaea_cecembensis	dialister_pneumosintes	
dialister_pneumosintes	bhargavaea_cecembensis	h2o_e,
bibersteinia_trehalosi	rodentibacter_pneumotropicus	
rodentibacter_pneumotropicus	bibersteinia_trehalosi	
bifidobacterium_actinocoloniiforme	paenibacillus_stellifer	abt__L_e,
paenibacillus_stellifer	bifidobacterium_actinocoloniiforme	h_e,
bifidobacterium_aesculapii	bifidobacterium_bohemicum	
bifidobacterium_bohemicum	bifidobacterium_aesculapii	val__L_e,
bifidobacterium_biavatii	bifidobacterium_scardovii	nh4_e,
bifidobacterium_scardovii	bifidobacterium_biavatii	
bifidobacterium_biavatii	collinsella_phocaeensis	nh4_e,
collinsella_phocaeensis	bifidobacterium_biavatii	h2o_e,pi_e,val__L_e,
bifidobacterium_bohemicum	bifidobacterium_thermophilum	h2o_e,val__L_e,ade_e,
bifidobacterium_thermophilum	bifidobacterium_bohemicum	glyc_e,
bifidobacterium_bohemicum	endozoicomonas_numazuensis	nh4_e,gly_e,ura_e,
endozoicomonas_numazuensis	bifidobacterium_bohemicum	ser__L_e,
bifidobacterium_bombi	clostridium_saccharobutylicum	acald_e,nh4_e,
clostridium_saccharobutylicum	bifidobacterium_bombi	
bifidobacterium_callitrichos	candidatus_soleaferrea	
candidatus_soleaferrea	bifidobacterium_callitrichos	
bifidobacterium_commune	caulobacter_vibrioides	
caulobacter_vibrioides	bifidobacterium_commune	h_e,
bifidobacterium_crudilactis	paracoccus_contaminans	ade_e,
paracoccus_contaminans	bifidobacterium_crudilactis	h2s_e,
bifidobacterium_gallicum	methylocapsa_palsarum	nh4_e,4abut_e,
methylocapsa_palsarum	bifidobacterium_gallicum	glu__L_e,h2s_e,
bifidobacterium_lemurum	saccharibacillus_sacchari	nh4_e,gua_e,
saccharibacillus_sacchari	bifidobacterium_lemurum	h2o_e,val__L_e,fe2_e,
bifidobacterium_mongoliense	paraglaciecola_psychrophila	glyclt_e,
paraglaciecola_psychrophila	bifidobacterium_mongoliense	acald_e,glu__L_e,
bifidobacterium_stellenboschense	paenibacillus_mucilaginosus	
paenibacillus_mucilaginosus	bifidobacterium_stellenboschense	pro__L_e,trp__L_e,
blastococcus_endophyticus	streptomyces_paucisporeus	glyc_e,nh4_e,
streptomyces_paucisporeus	blastococcus_endophyticus	gthrd_e,
blastococcus_saxobsidens	micromonospora_yangpuensis	h2o_e,
micromonospora_yangpuensis	blastococcus_saxobsidens	acald_e,orn_e,
blastopirellula_marina	chitinilyticum_aquatile	nh4_e,
chitinilyticum_aquatile	blastopirellula_marina	h2o_e,cu2_e,
blattabacterium_cuenoti	spongiibacterium_flavum	asp__L_e,
spongiibacterium_flavum	blattabacterium_cuenoti	pi_e,h2s_e,
blattella_germanica	lysinibacillus_fusiformis	
lysinibacillus_fusiformis	blattella_germanica	
blochmannia_endosymbiont	photorhabdus_temperata	
photorhabdus_temperata	blochmannia_endosymbiont	
blochmannia_endosymbiont	pontibacter_akesuensis	
pontibacter_akesuensis	blochmannia_endosymbiont	
bordetella_avium	tenacibaculum_holothuriorum	h2s_e,
tenacibaculum_holothuriorum	bordetella_avium	h2o_e,glu__L_e,
bordetella_bronchiseptica	shimwellia_blattae	ade_e,
shimwellia_blattae	bordetella_bronchiseptica	
bordetella_bronchiseptica	sphingomonas_changbaiensis	h2s_e,
sphingomonas_changbaiensis	bordetella_bronchiseptica	fe3_e,
bordetella_genomosp	microbulbifer_mangrovi	
microbulbifer_mangrovi	bordetella_genomosp	
bordetella_genomosp	mycobacterium_smegmatis	
mycobacterium_smegmatis	bordetella_genomosp	
bordetella_genomosp	candidatus_brocadia	
candidatus_brocadia	bordetella_genomosp	
bordetella_genomosp	lacunisphaera_limnophila	
lacunisphaera_limnophila	bordetella_genomosp	
bordetella_genomosp	nonlabens_dokdonensis	
nonlabens_dokdonensis	bordetella_genomosp	
bordetella_genomosp	roseovarius_nubinhibens	
roseovarius_nubinhibens	bordetella_genomosp	
bordetella_genomosp	sunxiuqinia_dokdonensis	
sunxiuqinia_dokdonensis	bordetella_genomosp	
bordetella_genomosp	sporosarcina_koreensis	
sporosarcina_koreensis	bordetella_genomosp	
bordetella_genomosp	sphingomonas_melonis	
sphingomonas_melonis	bordetella_genomosp	
bordetella_genomosp	corynebacterium_imitans	
corynebacterium_imitans	bordetella_genomosp	
bordetella_genomosp	erysipelothrix_larvae	
erysipelothrix_larvae	bordetella_genomosp	
bordetella_hinzii	corallococcus_coralloides	fe2_e,
corallococcus_coralloides	bordetella_hinzii	
bordetella_pertussis	chlorobium_phaeobacteroides	glyc_e,
chlorobium_phaeobacteroides	bordetella_pertussis	pi_e,
bordetella_petrii	erythrobacter_litoralis	
erythrobacter_litoralis	bordetella_petrii	
bordetella_petrii	flavobacterium_fluvii	ade_e,
flavobacterium_fluvii	bordetella_petrii	h2o_e,pi_e,
bordetella_trematum	myxococcus_xanthus	
myxococcus_xanthus	bordetella_trematum	
brachybacterium_phenoliresistens	enterococcus_casseliflavus	
enterococcus_casseliflavus	brachybacterium_phenoliresistens	h2o_e,gly_e,
brachyspira_hyodysenteriae	desulfotomaculum_hydrothermale	
desulfotomaculum_hydrothermale	brachyspira_hyodysenteriae	asp__L_e,ade_e,fe2_e,
brachyspira_murdochii	halobacillus_halophilus	
halobacillus_halophilus	brachyspira_murdochii	no2_e,pi_e,
brachyspira_murdochii	lysinibacillus_sphaericus	val__L_e,
lysinibacillus_sphaericus	brachyspira_murdochii	gly_e,pi_e,
brachyspira_murdochii	mycoplasma_bovoculi	
mycoplasma_bovoculi	brachyspira_murdochii	ala__L_e,
brachyspira_murdochii	sciscionella_marina	pyr_e,
sciscionella_marina	brachyspira_murdochii	pi_e,
bradyrhizobium_diazoefficiens	corynebacterium_mustelae	h2s_e,pi_e,
corynebacterium_mustelae	bradyrhizobium_diazoefficiens	cgly_e,
bradyrhizobium_diazoefficiens	nocardioides_dokdonensis	
nocardioides_dokdonensis	bradyrhizobium_diazoefficiens	h_e,cgly_e,
bradyrhizobium_japonicum	tepidimonas_taiwanensis	
tepidimonas_taiwanensis	bradyrhizobium_japonicum	
brevibacillus_laterosporus	methyloceanibacter_stevinii	fe3_e,
methyloceanibacter_stevinii	brevibacillus_laterosporus	nh4_e,ala__L_e,pi_e,
brevibacillus_massiliensis	geobacter_daltonii	
geobacter_daltonii	brevibacillus_massiliensis	pi_e,gua_e,
brevibacillus_panacihumi	dehalobacterium_formicoaceticum	h2o_e,
dehalobacterium_formicoaceticum	brevibacillus_panacihumi	
brevibacillus_panacihumi	lachnospiraceae_bacterium	acald_e,
lachnospiraceae_bacterium	brevibacillus_panacihumi	nh4_e,
brevibacillus_panacihumi	selenomonas_bovis	
selenomonas_bovis	brevibacillus_panacihumi	pi_e,
brevibacillus_panacihumi	thermaerobacter_marianensis	h2o_e,
thermaerobacter_marianensis	brevibacillus_panacihumi	pi_e,
brevibacterium_sandarakinum	nodularia_spumigena	
nodularia_spumigena	brevibacterium_sandarakinum	h_e,nh4_e,
brevundimonas_abyssalis	mycobacterium_leprae	nh4_e,
mycobacterium_leprae	brevundimonas_abyssalis	h_e,
brevundimonas_abyssalis	nocardioides_szechwanensis	nh4_e,h2s_e,
nocardioides_szechwanensis	brevundimonas_abyssalis	h_e,
brevundimonas_naejangsanensis	candidatus_rhodoluna	
candidatus_rhodoluna	brevundimonas_naejangsanensis	
brevundimonas_viscosa	helicobacter_cinaedi	pi_e,
helicobacter_cinaedi	brevundimonas_viscosa	h2s_e,
brevundimonas_viscosa	methylacidiphilum_infernorum	nh4_e,fe2_e,
methylacidiphilum_infernorum	brevundimonas_viscosa	h_e,h2s_e,
brevundimonas_viscosa	microterricola_viridarii	nh4_e,
microterricola_viridarii	brevundimonas_viscosa	
brochothrix_thermosphacta	pseudomonas_hussainii	nh4_e,ala__L_e,ala__D_e,
pseudomonas_hussainii	brochothrix_thermosphacta	h2o_e,pi_e,h2s_e,thym_e,
brochothrix_thermosphacta	pseudooceanicola_flagellatus	nh4_e,ala__L_e,
pseudooceanicola_flagellatus	brochothrix_thermosphacta	h2o_e,h2s_e,
brucella_melitensis	flavobacterium_haoranii	no2_e,h2s_e,
flavobacterium_haoranii	brucella_melitensis	glu__L_e,h_e,
burkholderia_gladioli	thiobacillus_thioparus	pi_e,fe3_e,
thiobacillus_thioparus	burkholderia_gladioli	acald_e,
burkholderia_gladioli	zunongwangia_profunda	pro__L_e,
zunongwangia_profunda	burkholderia_gladioli	acald_e,pyr_e,
burkholderia_ubonensis	maritalea_myrionectae	h2o_e,
maritalea_myrionectae	burkholderia_ubonensis	orn_e,
butyricimonas_synergistica	coprobacter_secundus	ade_e,
coprobacter_secundus	butyricimonas_synergistica	h2o_e,pi_e,
caballeronia_glebae	pararhizobium_polonicum	pi_e,
pararhizobium_polonicum	caballeronia_glebae	
caballeronia_zhejiangensis	enterobacter_cloacae	
enterobacter_cloacae	caballeronia_zhejiangensis	
caedibacter_varicaedens	hoeflea_phototrophica	h2o_e,
hoeflea_phototrophica	caedibacter_varicaedens	
caenispirillum_salinarum	oceanobacillus_oncorhynchi	
oceanobacillus_oncorhynchi	caenispirillum_salinarum	h2o_e,pi_e,
caenispirillum_salinarum	pontibacter_chinhatensis	ade_e,
pontibacter_chinhatensis	caenispirillum_salinarum	
caldanaerobacter_subterraneus	cyanobacterium_aponinum	h2o_e,
cyanobacterium_aponinum	caldanaerobacter_subterraneus	h_e,man1p_e,h2s_e,
caldanaerobius_fijiensis	tepidimicrobium_xylanilyticum	4abut_e,trp__L_e,
tepidimicrobium_xylanilyticum	caldanaerobius_fijiensis	h2s_e,fe2_e,
calderihabitans_maritimus	williamwhitmania_taraxaci	no2_e,asp__L_e,
williamwhitmania_taraxaci	calderihabitans_maritimus	
caldicellulosiruptor_bescii	corynebacterium_simulans	fum_e,
corynebacterium_simulans	caldicellulosiruptor_bescii	lac__L_e,fe2_e,
caldicellulosiruptor_saccharolyticus	oceanobacillus_timonensis	
oceanobacillus_timonensis	caldicellulosiruptor_saccharolyticus	ptrc_e,fe2_e,
caldisalinibacter_kiritimatiensis	clostridium_amylolyticum	
clostridium_amylolyticum	caldisalinibacter_kiritimatiensis	glu__L_e,asp__L_e,
caldisalinibacter_kiritimatiensis	clostridium_dakarense	pro__L_e,
clostridium_dakarense	caldisalinibacter_kiritimatiensis	glu__L_e,
caldisalinibacter_kiritimatiensis	clostridium_estertheticum	pi_e,lac__D_e,
clostridium_estertheticum	caldisalinibacter_kiritimatiensis	glu__L_e,
caldisalinibacter_kiritimatiensis	clostridium_lundense	h2o_e,h_e,lac__D_e,
clostridium_lundense	caldisalinibacter_kiritimatiensis	asp__L_e,glu__L_e,
caldisalinibacter_kiritimatiensis	prevotella_dentasini	h_e,h2_e,gua_e,pi_e,h2s_e,
prevotella_dentasini	caldisalinibacter_kiritimatiensis	asp__L_e,
caldisalinibacter_kiritimatiensis	romboutsia_timonensis	h2o_e,h_e,
romboutsia_timonensis	caldisalinibacter_kiritimatiensis	
caldisericum_exile	candidatus_paraburkholderia	
candidatus_paraburkholderia	caldisericum_exile	
calditerricola_satsumensis	ornithinibacillus_halophilus	h_e,etoh_e,thym_e,
ornithinibacillus_halophilus	calditerricola_satsumensis	glu__L_e,pi_e,h2s_e,
caldithrix_abyssi	marinibacterium_profundimaris	pi_e,
marinibacterium_profundimaris	caldithrix_abyssi	
caloramator_australicus	prolixibacter_bellariivorans	glyc_e,etoh_e,ade_e,
prolixibacter_bellariivorans	caloramator_australicus	h_e,
caloramator_mitchellensis	macrococcus_canis	
macrococcus_canis	caloramator_mitchellensis	h2o_e,
caloramator_quimbayensis	clostridium_argentinense	acald_e,
clostridium_argentinense	caloramator_quimbayensis	h_e,
caloramator_quimbayensis	clostridium_senegalense	acald_e,
clostridium_senegalense	caloramator_quimbayensis	lac__L_e,h_e,
caloramator_quimbayensis	lacimicrobium_alkaliphilum	h2o_e,ser__L_e,
lacimicrobium_alkaliphilum	caloramator_quimbayensis	h_e,
caloranaerobacter_ferrireducens	fusobacterium_perfoetens	h2o_e,h_e,pi_e,
fusobacterium_perfoetens	caloranaerobacter_ferrireducens	glu__L_e,acald_e,
caloranaerobacter_ferrireducens	lactococcus_garvieae	
lactococcus_garvieae	caloranaerobacter_ferrireducens	glu__L_e,ura_e,
caminibacter_mediatlanticus	pajaroellobacter_abortibovis	cgly_e,for_e,
pajaroellobacter_abortibovis	caminibacter_mediatlanticus	h2o_e,h_e,
campylobacter_cuniculorum	listeria_aquatica	pro__L_e,
listeria_aquatica	campylobacter_cuniculorum	val__L_e,nh4_e,succ_e,
campylobacter_fetus	fusobacterium_russii	ser__L_e,
fusobacterium_russii	campylobacter_fetus	h2o_e,cmp_e,
campylobacter_hepaticus	polaribacter_dokdonensis	inost_e,
polaribacter_dokdonensis	campylobacter_hepaticus	nh4_e,
campylobacter_hepaticus	streptomyces_cattleya	glyc_e,ade_e,
streptomyces_cattleya	campylobacter_hepaticus	pro__L_e,
campylobacter_hominis	pontibacter_ummariensis	bz_e,
pontibacter_ummariensis	campylobacter_hominis	h_e,h2s_e,
campylobacter_hyointestinalis	vibrio_panuliri	ura_e,ade_e,
vibrio_panuliri	campylobacter_hyointestinalis	no2_e,fe2_e,
campylobacter_iguaniorum	rhodopirellula_baltica	
rhodopirellula_baltica	campylobacter_iguaniorum	pi_e,
campylobacter_pinnipediorum	candidatus_midichloria	
candidatus_midichloria	campylobacter_pinnipediorum	
campylobacter_ureolyticus	enterobacter_cloacae	
enterobacter_cloacae	campylobacter_ureolyticus	
campylobacter_ureolyticus	halobacillus_mangrovi	val__L_e,
halobacillus_mangrovi	campylobacter_ureolyticus	glu__L_e,mal__L_e,fe2_e,
candidatus_accumulibacter	methylovulum_psychrotolerans	
methylovulum_psychrotolerans	candidatus_accumulibacter	
candidatus_arthromitus	geobacillus_thermodenitrificans	
geobacillus_thermodenitrificans	candidatus_arthromitus	
candidatus_arthromitus	desulfosporosinus_acididurans	
desulfosporosinus_acididurans	candidatus_arthromitus	
candidatus_arthromitus	mahella_australiensis	
mahella_australiensis	candidatus_arthromitus	
candidatus_arthromitus	turicibacter_sanguinis	
turicibacter_sanguinis	candidatus_arthromitus	
candidatus_azobacteroides	chitiniphilus_shinanonensis	
chitiniphilus_shinanonensis	candidatus_azobacteroides	
candidatus_azobacteroides	clostridium_merdae	
clostridium_merdae	candidatus_azobacteroides	
candidatus_azobacteroides	cohnella_laeviribosi	
cohnella_laeviribosi	candidatus_azobacteroides	
candidatus_azobacteroides	collinsella_bouchesdurhonensis	
collinsella_bouchesdurhonensis	candidatus_azobacteroides	
candidatus_azobacteroides	collinsella_ihuae	
collinsella_ihuae	candidatus_azobacteroides	
candidatus_azobacteroides	gordonibacter_massiliensis	
gordonibacter_massiliensis	candidatus_azobacteroides	
candidatus_azobacteroides	ndongobacter_massiliensis	
ndongobacter_massiliensis	candidatus_azobacteroides	
candidatus_azobacteroides	slackia_piriformis	
slackia_piriformis	candidatus_azobacteroides	
candidatus_baumannia	erwinia_amylovora	
erwinia_amylovora	candidatus_baumannia	
candidatus_blastococcus	sphingopyxis_fribergensis	
sphingopyxis_fribergensis	candidatus_blastococcus	
candidatus_blochmannia	lachnospiraceae_bacterium	
lachnospiraceae_bacterium	candidatus_blochmannia	
candidatus_blochmannia	lachnospiraceae_bacterium	
lachnospiraceae_bacterium	candidatus_blochmannia	
candidatus_blochmannia	ruminococcaceae_bacterium	
ruminococcaceae_bacterium	candidatus_blochmannia	
candidatus_blochmannia	ruminococcus_flavefaciens	
ruminococcus_flavefaciens	candidatus_blochmannia	
candidatus_blochmannia	croceicoccus_marinus	
croceicoccus_marinus	candidatus_blochmannia	
candidatus_blochmannia	deinococcus_ficus	
deinococcus_ficus	candidatus_blochmannia	
candidatus_blochmannia	rhodothermus_marinus	
rhodothermus_marinus	candidatus_blochmannia	
candidatus_brocadia	gracilimonas_tropica	
gracilimonas_tropica	candidatus_brocadia	
candidatus_brocadia	leadbetterella_byssophila	
leadbetterella_byssophila	candidatus_brocadia	
candidatus_burkholderia	xanthomonas_citri	
xanthomonas_citri	candidatus_burkholderia	
candidatus_burkholderia	nigerium_massiliense	
nigerium_massiliense	candidatus_burkholderia	
candidatus_chloroploca	sphingopyxis_flava	
sphingopyxis_flava	candidatus_chloroploca	
candidatus_chrysopegis	rhodanobacter_spathiphylli	
rhodanobacter_spathiphylli	candidatus_chrysopegis	
candidatus_dactylopiibacterium	chryseobacterium_piperi	
chryseobacterium_piperi	candidatus_dactylopiibacterium	
candidatus_desulforudis	euryhalocaulis_caribicus	
euryhalocaulis_caribicus	candidatus_desulforudis	
candidatus_desulfovibrio	lactobacillus_siliginis	
lactobacillus_siliginis	candidatus_desulfovibrio	
candidatus_doolittlea	candidatus_tachikawaea	
candidatus_tachikawaea	candidatus_doolittlea	
candidatus_doolittlea	diplorickettsia_massiliensis	
diplorickettsia_massiliensis	candidatus_doolittlea	
candidatus_erwinia	enterobacter_cloacae	
enterobacter_cloacae	candidatus_erwinia	
candidatus_fukatsuia	shewanella_baltica	
shewanella_baltica	candidatus_fukatsuia	
candidatus_fukatsuia	streptomyces_pathocidini	
streptomyces_pathocidini	candidatus_fukatsuia	
candidatus_gullanella	candidatus_moranella	
candidatus_moranella	candidatus_gullanella	
candidatus_gullanella	enterobacter_cloacae	
enterobacter_cloacae	candidatus_gullanella	
candidatus_hoaglandella	colwellia_chukchiensis	
colwellia_chukchiensis	candidatus_hoaglandella	
candidatus_hoaglandella	oleibacter_marinus	
oleibacter_marinus	candidatus_hoaglandella	
candidatus_hoaglandella	secondary_endosymbiont	
secondary_endosymbiont	candidatus_hoaglandella	
candidatus_hoaglandella	xenorhabdus_doucetiae	
xenorhabdus_doucetiae	candidatus_hoaglandella	
candidatus_ishikawaella	halomonas_huangheensis	
halomonas_huangheensis	candidatus_ishikawaella	
candidatus_izimaplasma	pelagibaca_abyssi	
pelagibaca_abyssi	candidatus_izimaplasma	
candidatus_koribacter	enterobacter_cloacae	
enterobacter_cloacae	candidatus_koribacter	
candidatus_kryptobacter	flavobacterium_enshiense	
flavobacterium_enshiense	candidatus_kryptobacter	
candidatus_magnetobacterium	rhizobium_gallicum	
rhizobium_gallicum	candidatus_magnetobacterium	
candidatus_marispirochaeta	demequina_aurantiaca	
demequina_aurantiaca	candidatus_marispirochaeta	
candidatus_methanomethylophilus	mycobacterium_franklinii	
mycobacterium_franklinii	candidatus_methanomethylophilus	
candidatus_mikella	enterobacter_cloacae	
enterobacter_cloacae	candidatus_mikella	
candidatus_mikella	hippea_jasoniae	
hippea_jasoniae	candidatus_mikella	
candidatus_neoehrlichia	terracidiphilus_gabretensis	
terracidiphilus_gabretensis	candidatus_neoehrlichia	
candidatus_nitrosoglobus	staphylococcus_lutrae	
staphylococcus_lutrae	candidatus_nitrosoglobus	
candidatus_nitrospira	helicobacter_canadensis	
helicobacter_canadensis	candidatus_nitrospira	
candidatus_nitrospira	pantoea_ananatis	
pantoea_ananatis	candidatus_nitrospira	
candidatus_nitrospira	chroococcidiopsis_thermalis	
chroococcidiopsis_thermalis	candidatus_nitrospira	
candidatus_nitrospira	halotalea_alkalilenta	
halotalea_alkalilenta	candidatus_nitrospira	
candidatus_pantoea	thaumasiovibrio_occultus	
thaumasiovibrio_occultus	candidatus_pantoea	
candidatus_pelagibacter	exiguobacterium_sibiricum	
exiguobacterium_sibiricum	candidatus_pelagibacter	
candidatus_pelagibacter	corynebacterium_sputi	
corynebacterium_sputi	candidatus_pelagibacter	
candidatus_pelagibacter	pediococcus_claussenii	
pediococcus_claussenii	candidatus_pelagibacter	
candidatus_pelagibacter	maritimibacter_alkaliphilus	
maritimibacter_alkaliphilus	candidatus_pelagibacter	
candidatus_pelagibacter	pseudomonas_oryzae	
pseudomonas_oryzae	candidatus_pelagibacter	
candidatus_pelagibacter	herminiimonas_arsenicoxydans	
herminiimonas_arsenicoxydans	candidatus_pelagibacter	
candidatus_phaeomarinobacter	pelobacter_acetylenicus	
pelobacter_acetylenicus	candidatus_phaeomarinobacter	
candidatus_photodesmus	helicobacter_fennelliae	
helicobacter_fennelliae	candidatus_photodesmus	
candidatus_phytoplasma	comamonas_aquatica	
comamonas_aquatica	candidatus_phytoplasma	
candidatus_planktophila	streptomyces_nodosus	
streptomyces_nodosus	candidatus_planktophila	
candidatus_planktophila	rhodoluna_lacicola	
rhodoluna_lacicola	candidatus_planktophila	
candidatus_planktophila	enterobacter_cloacae	
enterobacter_cloacae	candidatus_planktophila	
candidatus_planktophila	mycoplasma_hyorhinis	
mycoplasma_hyorhinis	candidatus_planktophila	
candidatus_portiera	corynebacterium_pyruviciproducens	
corynebacterium_pyruviciproducens	candidatus_portiera	
candidatus_profftella	mycoplasma_crocodyli	
mycoplasma_crocodyli	candidatus_profftella	
candidatus_puniceispirillum	fulvivirga_imtechensis	
fulvivirga_imtechensis	candidatus_puniceispirillum	
candidatus_rhodobacter	haliscomenobacter_hydrossis	
haliscomenobacter_hydrossis	candidatus_rhodobacter	
candidatus_riesia	desulfarculus_baarsii	
desulfarculus_baarsii	candidatus_riesia	
candidatus_scalindua	komagataeibacter_medellinensis	
komagataeibacter_medellinensis	candidatus_scalindua	
candidatus_scalindua	streptomyces_wuyuanensis	
streptomyces_wuyuanensis	candidatus_scalindua	
candidatus_sodalis	enterobacter_cloacae	
enterobacter_cloacae	candidatus_sodalis	
candidatus_solibacter	hymenobacter_daecheongensis	
hymenobacter_daecheongensis	candidatus_solibacter	
candidatus_solibacter	mycobacterium_rutilum	
mycobacterium_rutilum	candidatus_solibacter	
candidatus_solibacter	skermanella_aerolata	
skermanella_aerolata	candidatus_solibacter	
candidatus_stoquefichus	lachnospiraceae_bacterium	
lachnospiraceae_bacterium	candidatus_stoquefichus	
candidatus_stoquefichus	lachnospiraceae_bacterium	
lachnospiraceae_bacterium	candidatus_stoquefichus	
candidatus_stoquefichus	lachnospiraceae_bacterium	
lachnospiraceae_bacterium	candidatus_stoquefichus	
candidatus_stoquefichus	lachnospiraceae_bacterium	
lachnospiraceae_bacterium	candidatus_stoquefichus	
candidatus_stoquefichus	lachnospiraceae_bacterium	
lachnospiraceae_bacterium	candidatus_stoquefichus	
candidatus_stoquefichus	lachnospiraceae_bacterium	
lachnospiraceae_bacterium	candidatus_stoquefichus	
candidatus_stoquefichus	oscillibacter_ruminantium	
oscillibacter_ruminantium	candidatus_stoquefichus	
candidatus_stoquefichus	oscillibacter_valericigenes	
oscillibacter_valericigenes	candidatus_stoquefichus	
candidatus_stoquefichus	prevotellamassilia_timonensis	
prevotellamassilia_timonensis	candidatus_stoquefichus	
candidatus_stoquefichus	sharpea_azabuensis	
sharpea_azabuensis	candidatus_stoquefichus	
candidatus_symbiobacter	pseudodonghicola_xiamenensis	
pseudodonghicola_xiamenensis	candidatus_symbiobacter	
candidatus_symbiothrix	domibacillus_antri	
domibacillus_antri	candidatus_symbiothrix	
candidatus_symbiothrix	spirosoma_radiotolerans	
spirosoma_radiotolerans	candidatus_symbiothrix	
candidatus_symbiothrix	treponema_denticola	
treponema_denticola	candidatus_symbiothrix	
candidatus_thiodiazotropha	desulfovibrio_piger	
desulfovibrio_piger	candidatus_thiodiazotropha	
candidatus_thiosymbion	virgibacillus_alimentarius	
virgibacillus_alimentarius	candidatus_thiosymbion	
candidatus_tremblaya	streptomyces_indicus	
streptomyces_indicus	candidatus_tremblaya	
candidatus_tremblaya	mucilaginibacter_paludis	
mucilaginibacter_paludis	candidatus_tremblaya	
candidimonas_bauzanensis	marinobacter_subterrani	pro__L_e,
marinobacter_subterrani	candidimonas_bauzanensis	
candidimonas_nitroreducens	pseudooceanicola_marinus	fe3_e,
pseudooceanicola_marinus	candidimonas_nitroreducens	nh4_e,acald_e,
capnocytophaga_canimorsus	maribacter_forsetii	h2o_e,
maribacter_forsetii	capnocytophaga_canimorsus	acald_e,no2_e,pi_e,
capnocytophaga_cynodegmi	siansivirga_zeaxanthinifaciens	acald_e,h2s_e,
siansivirga_zeaxanthinifaciens	capnocytophaga_cynodegmi	h_e,
capnocytophaga_haemolytica	chitinilyticum_aquatile	h_e,
chitinilyticum_aquatile	capnocytophaga_haemolytica	acald_e,h2o_e,
capnocytophaga_ochracea	lysobacter_daejeonensis	pi_e,
lysobacter_daejeonensis	capnocytophaga_ochracea	nh4_e,
carboxydothermus_hydrogenoformans	roseovarius_azorensis	
roseovarius_azorensis	carboxydothermus_hydrogenoformans	h_e,pi_e,
carboxydothermus_pertinax	corynebacterium_halotolerans	asp__L_e,
corynebacterium_halotolerans	carboxydothermus_pertinax	val__L_e,
carnobacterium_iners	thermodesulfobium_narugense	h_e,pi_e,
thermodesulfobium_narugense	carnobacterium_iners	orn_e,acald_e,
carnobacterium_maltaromaticum	ralstonia_pickettii	h_e,h2o_e,
ralstonia_pickettii	carnobacterium_maltaromaticum	acald_e,asp__L_e,thym_e,
castellaniella_defragrans	paraburkholderia_megapolitana	
paraburkholderia_megapolitana	castellaniella_defragrans	
castellaniella_defragrans	spirosoma_montaniterrae	fe2_e,
spirosoma_montaniterrae	castellaniella_defragrans	
catalinimonas_alkaloidigena	salibacterium_halotolerans	h_e,fe3_e,cu2_e,
salibacterium_halotolerans	catalinimonas_alkaloidigena	acald_e,cgly_e,
catenovulum_agarivorans	streptococcus_merionis	fe2_e,
streptococcus_merionis	catenovulum_agarivorans	h2o_e,pi_e,h2s_e,
catenovulum_maritimum	secondary_endosymbiont	fum_e,h2s_e,pi_e,pi_e,
secondary_endosymbiont	catenovulum_maritimum	h_e,nh4_e,h2o_e,h_e,succ_e,
caulobacter_henricii	ornithinimicrobium_pekingense	glu__L_e,cu2_e,
ornithinimicrobium_pekingense	caulobacter_henricii	pi_e,ade_e,h2s_e,
caulobacter_segnis	dictyoglomus_turgidum	h_e,thym_e,
dictyoglomus_turgidum	caulobacter_segnis	nh4_e,
caulobacter_segnis	kiloniella_spongiae	h_e,
kiloniella_spongiae	caulobacter_segnis	nh4_e,
caulobacter_segnis	wenxinia_marina	h_e,
wenxinia_marina	caulobacter_segnis	
caulobacter_segnis	xanthomonas_maliensis	h_e,
xanthomonas_maliensis	caulobacter_segnis	nh4_e,
caviibacter_abscessus	lactobacillus_brevis	pi_e,val__L_e,trp__L_e,bz_e,
lactobacillus_brevis	caviibacter_abscessus	h_e,h2o_e,
cecembia_lonarensis	lactobacillus_parafarraginis	h2o_e,
lactobacillus_parafarraginis	cecembia_lonarensis	ala__L_e,h2s_e,
cecembia_lonarensis	mesorhizobium_alhagi	h2o_e,pyr_e,fe2_e,
mesorhizobium_alhagi	cecembia_lonarensis	nh4_e,h2s_e,
celeribacter_baekdonensis	sedimentitalea_nanhaiensis	h2o_e,for_e,
sedimentitalea_nanhaiensis	celeribacter_baekdonensis	nh4_e,
celeribacter_ethanolicus	pontibacter_ummariensis	acald_e,
pontibacter_ummariensis	celeribacter_ethanolicus	h_e,pi_e,pro__L_e,fe3_e,
celeribacter_halophilus	spiroplasma_cantharicola	acald_e,orn_e,
spiroplasma_cantharicola	celeribacter_halophilus	h2o_e,cu2_e,
celeribacter_indicus	treponema_caldarium	acald_e,fum_e,pi_e,
treponema_caldarium	celeribacter_indicus	orn_e,cu2_e,succ_e,
celeribacter_marinus	roseovarius_lutimaris	orn_e,
roseovarius_lutimaris	celeribacter_marinus	h2o_e,
celeribacter_neptunius	hymenobacter_glacialis	fum_e,acald_e,
hymenobacter_glacialis	celeribacter_neptunius	pi_e,for_e,
cellulomonas_carbonis	cupriavidus_necator	nh4_e,
cupriavidus_necator	cellulomonas_carbonis	acald_e,
cellulomonas_marina	henriciella_aquimarina	cu2_e,
henriciella_aquimarina	cellulomonas_marina	for_e,
cellulomonas_massiliensis	soli_cunha	
soli_cunha	cellulomonas_massiliensis	
cellulosimicrobium_cellulans	flexistipes_sinusarabici	h_e,pi_e,
flexistipes_sinusarabici	cellulosimicrobium_cellulans	nh4_e,
cellvibrio_japonicus	tropicibacter_multivorans	acald_e,
tropicibacter_multivorans	cellvibrio_japonicus	
cephaloticoccus_capnophilus	leptospira_biflexa	glu__L_e,nh4_e,
leptospira_biflexa	cephaloticoccus_capnophilus	h_e,for_e,
cephaloticoccus_primus	weissella_bombi	pi_e,
weissella_bombi	cephaloticoccus_primus	nh4_e,
cesiribacter_andamanensis	flavobacterium_akiainvivens	
flavobacterium_akiainvivens	cesiribacter_andamanensis	pi_e,fe2_e,for_e,
chishuiella_changwenlii	gracilibacillus_lacisalsi	val__L_e,
gracilibacillus_lacisalsi	chishuiella_changwenlii	h2o_e,pi_e,
chitinilyticum_aquatile	geobacter_bemidjiensis	fum_e,cu2_e,
geobacter_bemidjiensis	chitinilyticum_aquatile	glyclt_e,ura_e,
chitinilyticum_aquatile	rhodobaca_barguzinensis	h2o_e,
rhodobaca_barguzinensis	chitinilyticum_aquatile	
chitinilyticum_aquatile	sphaerochaeta_globosa	acald_e,h2o_e,
sphaerochaeta_globosa	chitinilyticum_aquatile	h_e,
chitinilyticum_litopenaei	nitrobacter_hamburgensis	
nitrobacter_hamburgensis	chitinilyticum_litopenaei	
chitinimonas_koreensis	pontibacter_indicus	pi_e,h2s_e,
pontibacter_indicus	chitinimonas_koreensis	
chitinimonas_koreensis	sanguibacteroides_justesenii	pi_e,ade_e,h2s_e,
sanguibacteroides_justesenii	chitinimonas_koreensis	
chitinivibrio_alkaliphilus	crocosphaera_watsonii	
crocosphaera_watsonii	chitinivibrio_alkaliphilus	pi_e,
chitinivibrio_alkaliphilus	xylella_taiwanensis	acald_e,
xylella_taiwanensis	chitinivibrio_alkaliphilus	
chitinophaga_costaii	pediococcus_cellicola	glyc_e,
pediococcus_cellicola	chitinophaga_costaii	
chitinophaga_costaii	roseivirga_spongicola	
roseivirga_spongicola	chitinophaga_costaii	h2o_e,
chitinophaga_eiseniae	sphaerochaeta_pleomorpha	asp__L_e,h2s_e,
sphaerochaeta_pleomorpha	chitinophaga_eiseniae	nh4_e,
chitinophaga_jiangningensis	mariprofundus_micogutta	pi_e,fe2_e,
mariprofundus_micogutta	chitinophaga_jiangningensis	nh4_e,h2s_e,gthrd_e,asp__L_e,
chitinophaga_niabensis	pontibacter_akesuensis	
pontibacter_akesuensis	chitinophaga_niabensis	
chitinophaga_pinensis	chitinophaga_rupis	
chitinophaga_rupis	chitinophaga_pinensis	
chitinophaga_rupis	rathayibacter_toxicus	for_e,
rathayibacter_toxicus	chitinophaga_rupis	
chitinophaga_rupis	yangia_pacifica	pi_e,
yangia_pacifica	chitinophaga_rupis	h2o_e,
chitinophaga_sancti	chryseobacterium_indologenes	h2s_e,
chryseobacterium_indologenes	chitinophaga_sancti	asp__L_e,
chitinophaga_terrae	sphingobacterium_psychroaquaticum	pi_e,h2s_e,
sphingobacterium_psychroaquaticum	chitinophaga_terrae	h_e,glcur_e,for_e,
chitinophaga_terrae	thermophagus_xiamenensis	
thermophagus_xiamenensis	chitinophaga_terrae	
chloracidobacterium_thermophilum	kangiella_koreensis	
kangiella_koreensis	chloracidobacterium_thermophilum	acald_e,nh4_e,h2s_e,pi_e,
chlorobaculum_limnaeum	sideroxydans_lithotrophicus	ser__D_e,h_e,
sideroxydans_lithotrophicus	chlorobaculum_limnaeum	
chlorobium_chlorochromatii	pseudothermotoga_hypogea	h_e,acald_e,
pseudothermotoga_hypogea	chlorobium_chlorochromatii	pi_e,
chlorobium_chlorochromatii	staphylococcus_succinus	h_e,for_e,
staphylococcus_succinus	chlorobium_chlorochromatii	h2o_e,
chlorobium_chlorochromatii	sulfitobacter_noctilucicola	
sulfitobacter_noctilucicola	chlorobium_chlorochromatii	nh4_e,
chlorobium_ferrooxidans	oceanicella_actignis	acald_e,etoh_e,no2_e,nh4_e,h2o_e,fe3_e,for_e,
oceanicella_actignis	chlorobium_ferrooxidans	
chlorobium_limicola	rhodopirellula_maiorica	
rhodopirellula_maiorica	chlorobium_limicola	
chlorobium_phaeovibrioides	siansivirga_zeaxanthinifaciens	acald_e,h2s_e,
siansivirga_zeaxanthinifaciens	chlorobium_phaeovibrioides	h2o_e,h_e,pi_e,
chloroflexus_aggregans	listeria_booriae	h_e,
listeria_booriae	chloroflexus_aggregans	nh4_e,
chlorogloeopsis_fritschii	polaribacter_atrinae	
polaribacter_atrinae	chlorogloeopsis_fritschii	h2o_e,
chondromyces_apiculatus	jannaschia_pohangensis	
jannaschia_pohangensis	chondromyces_apiculatus	h_e,
chondromyces_apiculatus	lactobacillus_saniviri	acald_e,pro__L_e,
lactobacillus_saniviri	chondromyces_apiculatus	h_e,
chondromyces_crocatus	desulfoplanes_formicivorans	
desulfoplanes_formicivorans	chondromyces_crocatus	h2o_e,
chondromyces_crocatus	halomonas_shengliensis	nh4_e,
halomonas_shengliensis	chondromyces_crocatus	cys__L_e,
chondromyces_crocatus	roseobacter_denitrificans	nh4_e,
roseobacter_denitrificans	chondromyces_crocatus	
christensenella_timonensis	clostridium_kluyveri	acald_e,
clostridium_kluyveri	christensenella_timonensis	nh4_e,pi_e,pro__L_e,fe2_e,succ_e,
christensenella_timonensis	microvirga_vignae	acald_e,glu__L_e,cu2_e,
microvirga_vignae	christensenella_timonensis	pro__L_e,fe2_e,
christensenella_timonensis	paenibacillus_fonticola	acald_e,ade_e,
paenibacillus_fonticola	christensenella_timonensis	pro__L_e,fe2_e,
christensenella_timonensis	ruminococcaceae_bacterium	acald_e,
ruminococcaceae_bacterium	christensenella_timonensis	ala__L_e,pro__L_e,
chromobacterium_haemolyticum	leptolyngbya_valderiana	h2o_e,
leptolyngbya_valderiana	chromobacterium_haemolyticum	nh4_e,asp__L_e,gly_e,
chromohalobacter_salexigens	solimonas_flava	pi_e,cu2_e,
solimonas_flava	chromohalobacter_salexigens	acald_e,asp__L_e,
chroococcidiopsis_thermalis	mycobacterium_longobardum	no2_e,pyr_e,
mycobacterium_longobardum	chroococcidiopsis_thermalis	
chryseobacterium_angstadtii	nocardioides_lianchengensis	
nocardioides_lianchengensis	chryseobacterium_angstadtii	h2s_e,fe2_e,
chryseobacterium_bovis	haliscomenobacter_hydrossis	fe3_e,asp__L_e,glyc_e,fum_e,
haliscomenobacter_hydrossis	chryseobacterium_bovis	h2o_e,fe2_e,h2s_e,
chryseobacterium_bovis	rhodoferax_saidenbachensis	pi_e,asp__L_e,orn_e,
rhodoferax_saidenbachensis	chryseobacterium_bovis	h_e,h2o_e,
chryseobacterium_caeni	nocardioides_lianchengensis	orn_e,
nocardioides_lianchengensis	chryseobacterium_caeni	h2s_e,
chryseobacterium_daeguense	treponema_pedis	pi_e,
treponema_pedis	chryseobacterium_daeguense	ala__L_e,
chryseobacterium_gregarium	oceanobacillus_senegalensis	thym_e,
oceanobacillus_senegalensis	chryseobacterium_gregarium	
chryseobacterium_halperniae	flavobacterium_fontis	
flavobacterium_fontis	chryseobacterium_halperniae	h_e,fe2_e,
chryseobacterium_halperniae	salinivibrio_proteolyticus	
salinivibrio_proteolyticus	chryseobacterium_halperniae	h2s_e,fe2_e,
chryseobacterium_hispalense	elizabethkingia_anophelis	
elizabethkingia_anophelis	chryseobacterium_hispalense	asp__L_e,
chryseobacterium_hominis	paracoccus_chinensis	
paracoccus_chinensis	chryseobacterium_hominis	
chryseobacterium_palustre	perlucidibaca_piscinae	
perlucidibaca_piscinae	chryseobacterium_palustre	h2s_e,fe2_e,
chryseobacterium_piscicola	flavobacterium_rivuli	asp__L_e,
flavobacterium_rivuli	chryseobacterium_piscicola	
chryseobacterium_polytrichastri	chryseobacterium_taihuense	glu__L_e,h2s_e,
chryseobacterium_taihuense	chryseobacterium_polytrichastri	
chryseobacterium_solincola	poseidonocella_pacifica	
poseidonocella_pacifica	chryseobacterium_solincola	h2o_e,h2s_e,fe2_e,
chryseobacterium_taihuense	dermacoccus_nishinomiyaensis	h2o_e,
dermacoccus_nishinomiyaensis	chryseobacterium_taihuense	gua_e,h2s_e,
chryseobacterium_wanjuense	sphingomonas_koreensis	
sphingomonas_koreensis	chryseobacterium_wanjuense	pi_e,h2s_e,
chryseolinea_serpens	hymenobacter_psychrotolerans	asp__L_e,h2s_e,
hymenobacter_psychrotolerans	chryseolinea_serpens	h2o_e,pi_e,
chrysiogenes_arsenatis	marivita_cryptomonadis	fe3_e,
marivita_cryptomonadis	chrysiogenes_arsenatis	nh4_e,pi_e,
chthoniobacter_flavus	ornatilinea_apprima	h2o_e,h_e,h2s_e,
ornatilinea_apprima	chthoniobacter_flavus	nh4_e,bz_e,
chthonomonas_calidirosea	haliscomenobacter_hydrossis	
haliscomenobacter_hydrossis	chthonomonas_calidirosea	h2o_e,
clavibacter_michiganensis	demequina_sediminicola	h2s_e,
demequina_sediminicola	clavibacter_michiganensis	h2o_e,nh4_e,acald_e,
cloacibacillus_evryensis	myxococcus_stipitatus	h2o_e,
myxococcus_stipitatus	cloacibacillus_evryensis	ser__D_e,ala__D_e,
clostridium_bornimense	gottschalkia_acidurici	ura_e,
gottschalkia_acidurici	clostridium_bornimense	nh4_e,
clostridium_cavendishii	clostridium_chauvoei	fum_e,trp__L_e,
clostridium_chauvoei	clostridium_cavendishii	
clostridium_cavendishii	streptobacillus_moniliformis	fum_e,orn_e,trp__L_e,
streptobacillus_moniliformis	clostridium_cavendishii	val__L_e,
clostridium_cellulosi	corynebacterium_bouchesdurhonense	h2o_e,
corynebacterium_bouchesdurhonense	clostridium_cellulosi	h2s_e,
clostridium_cellulosi	sorangium_cellulosum	asp__L_e,
sorangium_cellulosum	clostridium_cellulosi	h2s_e,
clostridium_cellulovorans	treponema_saccharophilum	h2o_e,
treponema_saccharophilum	clostridium_cellulovorans	acald_e,
clostridium_clariflavum	flavobacterium_seoulense	acald_e,succ_e,
flavobacterium_seoulense	clostridium_clariflavum	h2o_e,pi_e,fe2_e,
clostridium_ihumii	natranaerobius_thermophilus	h2o_e,mal__L_e,val__L_e,
natranaerobius_thermophilus	clostridium_ihumii	lac__L_e,pro__L_e,ade_e,
clostridium_novyi	clostridium_saccharobutylicum	nh4_e,
clostridium_saccharobutylicum	clostridium_novyi	glu__L_e,
clostridium_stercorarium	dehalogenimonas_alkenigignens	nh4_e,
dehalogenimonas_alkenigignens	clostridium_stercorarium	h_e,h2o_e,
clostridium_stercorarium	desulfosporosinus_youngiae	nh4_e,
desulfosporosinus_youngiae	clostridium_stercorarium	
clostridium_stercorarium	hymenobacter_coccineus	nh4_e,
hymenobacter_coccineus	clostridium_stercorarium	h_e,
clostridium_stercorarium	negativicoccus_massiliensis	nh4_e,pro__L_e,
negativicoccus_massiliensis	clostridium_stercorarium	val__L_e,
clostridium_tyrobutyricum	paenibacillus_beijingensis	acald_e,ade_e,
paenibacillus_beijingensis	clostridium_tyrobutyricum	pi_e,h2o_e,h2s_e,
cnuella_takakiae	noviherbaspirillum_denitrificans	
noviherbaspirillum_denitrificans	cnuella_takakiae	acald_e,ade_e,
cnuella_takakiae	prevotella_buccae	
prevotella_buccae	cnuella_takakiae	nh4_e,
cobetia_crustatorum	saccharomonospora_viridis	h2o_e,h_e,
saccharomonospora_viridis	cobetia_crustatorum	
cohaesibacter_marisflavi	methylomonas_methanica	
methylomonas_methanica	cohaesibacter_marisflavi	fum_e,for_e,
cohnella_kolymensis	salinispira_pacifica	lac__D_e,val__L_e,
salinispira_pacifica	cohnella_kolymensis	h_e,pi_e,ile__L_e,gua_e,
cohnella_panacarvi	flavobacterium_terrae	h2o_e,h_e,
flavobacterium_terrae	cohnella_panacarvi	pi_e,h2s_e,
cohnella_thermotolerans	pseudomonas_sagittaria	pyr_e,
pseudomonas_sagittaria	cohnella_thermotolerans	h2o_e,pi_e,val__L_e,h2s_e,
collimonas_pratensis	thermanaerovibrio_acidaminovorans	h2s_e,
thermanaerovibrio_acidaminovorans	collimonas_pratensis	
collinsella_tanakaei	desulfitobacterium_hafniense	h2o_e,
desulfitobacterium_hafniense	collinsella_tanakaei	no2_e,pi_e,ade_e,orn_e,
collinsella_tanakaei	enterorhabdus_caecimuris	ile__L_e,
enterorhabdus_caecimuris	collinsella_tanakaei	h_e,pi_e,val__L_e,ade_e,no2_e,
collinsella_tanakaei	gordonibacter_pamelaeae	
gordonibacter_pamelaeae	collinsella_tanakaei	val__L_e,h2s_e,
collinsella_tanakaei	selenomonas_ruminantium	h2_e,h2o_e,
selenomonas_ruminantium	collinsella_tanakaei	no2_e,pi_e,ade_e,
collinsella_tanakaei	senegalimassilia_anaerobia	ile__L_e,fe2_e,
senegalimassilia_anaerobia	collinsella_tanakaei	no2_e,ade_e,
colwellia_aestuarii	vibrio_alginolyticus	
vibrio_alginolyticus	colwellia_aestuarii	acald_e,
colwellia_mytili	pseudomonas_protegens	
pseudomonas_protegens	colwellia_mytili	ura_e,h_e,ade_e,
comamonas_composti	sphingomonas_rubra	
sphingomonas_rubra	comamonas_composti	cu2_e,
comamonas_serinivorans	jannaschia_seosinensis	
jannaschia_seosinensis	comamonas_serinivorans	h2o_e,
comamonas_serinivorans	rubellimicrobium_mesophilum	acald_e,ade_e,
rubellimicrobium_mesophilum	comamonas_serinivorans	
comamonas_terrae	paenibacillus_swuensis	pi_e,
paenibacillus_swuensis	comamonas_terrae	h2o_e,glu__L_e,cu2_e,
conexibacter_woesei	janibacter_corallicola	nh4_e,orn_e,for_e,
janibacter_corallicola	conexibacter_woesei	h2o_e,
conexibacter_woesei	nesterenkonia_massiliensis	nh4_e,for_e,
nesterenkonia_massiliensis	conexibacter_woesei	h2o_e,
coprobacter_fastidiosus	lachnospiraceae_bacterium	
lachnospiraceae_bacterium	coprobacter_fastidiosus	ade_e,
coprobacter_fastidiosus	paraprevotella_xylaniphila	
paraprevotella_xylaniphila	coprobacter_fastidiosus	
corallococcus_coralloides	pseudomonas_monteilii	
pseudomonas_monteilii	corallococcus_coralloides	fe2_e,
coriobacterium_glomerans	paenibacillus_oryzae	gua_e,ade_e,h2s_e,succ_e,
paenibacillus_oryzae	coriobacterium_glomerans	fe2_e,
corynebacterium_ammoniagenes	pseudomonas_alcaligenes	pro__L_e,cu2_e,
pseudomonas_alcaligenes	corynebacterium_ammoniagenes	glu__L_e,val__L_e,
corynebacterium_aquilae	siphonobacter_aquaeclarae	glyald_e,
siphonobacter_aquaeclarae	corynebacterium_aquilae	h2o_e,pi_e,
corynebacterium_argentoratense	ramlibacter_tataouinensis	
ramlibacter_tataouinensis	corynebacterium_argentoratense	
corynebacterium_atypicum	kribbella_flavida	no2_e,
kribbella_flavida	corynebacterium_atypicum	h2o_e,
corynebacterium_camporealensis	mycobacterium_aromaticivorans	
mycobacterium_aromaticivorans	corynebacterium_camporealensis	h2o_e,mal__L_e,
corynebacterium_camporealensis	nitrolancea_hollandica	
nitrolancea_hollandica	corynebacterium_camporealensis	mal__L_e,for_e,
corynebacterium_cystitidis	cryobacterium_psychrotolerans	lac__L_e,
cryobacterium_psychrotolerans	corynebacterium_cystitidis	
corynebacterium_deserti	dissulfuribacter_thermophilus	pi_e,h2s_e,
dissulfuribacter_thermophilus	corynebacterium_deserti	
corynebacterium_doosanense	corynebacterium_variabile	
corynebacterium_variabile	corynebacterium_doosanense	h2o_e,h_e,no2_e,val__L_e,
corynebacterium_doosanense	friedmanniella_flava	glu__L_e,fum_e,
friedmanniella_flava	corynebacterium_doosanense	h2o_e,icit_e,
corynebacterium_efficiens	lactobacillus_amylolyticus	pi_e,
lactobacillus_amylolyticus	corynebacterium_efficiens	ala__L_e,nh4_e,
corynebacterium_falsenii	streptomyces_thermoautotrophicus	
streptomyces_thermoautotrophicus	corynebacterium_falsenii	h_e,gua_e,
corynebacterium_flavescens	salinicoccus_halodurans	pi_e,val__L_e,
salinicoccus_halodurans	corynebacterium_flavescens	h2o_e,
corynebacterium_frankenforstense	cupriavidus_gilardii	pi_e,nh4_e,
cupriavidus_gilardii	corynebacterium_frankenforstense	h2o_e,glu__L_e,
corynebacterium_halotolerans	corynebacterium_lubricantis	no2_e,
corynebacterium_lubricantis	corynebacterium_halotolerans	
corynebacterium_imitans	saccharopolyspora_jiangxiensis	
saccharopolyspora_jiangxiensis	corynebacterium_imitans	pi_e,
corynebacterium_imitans	streptacidiphilus_oryzae	acald_e,
streptacidiphilus_oryzae	corynebacterium_imitans	
corynebacterium_jeikeium	janibacter_hoylei	glu__L_e,nh4_e,
janibacter_hoylei	corynebacterium_jeikeium	h_e,
corynebacterium_kutscheri	kaistia_granuli	h2o_e,h_e,
kaistia_granuli	corynebacterium_kutscheri	h2s_e,
corynebacterium_lactis	pseudonocardia_oroxyli	
pseudonocardia_oroxyli	corynebacterium_lactis	h2o_e,h_e,pi_e,
corynebacterium_marinum	leptotrichia_goodfellowii	
leptotrichia_goodfellowii	corynebacterium_marinum	gly_e,ile__L_e,ala__D_e,h2s_e,
corynebacterium_maris	xanthobacter_autotrophicus	nh4_e,
xanthobacter_autotrophicus	corynebacterium_maris	ala__L_e,
corynebacterium_massiliense	sphingobium_chlorophenolicum	h2o_e,h_e,val__L_e,
sphingobium_chlorophenolicum	corynebacterium_massiliense	ile__L_e,pro__L_e,
corynebacterium_mycetoides	hoyosella_subflava	glu__L_e,
hoyosella_subflava	corynebacterium_mycetoides	nh4_e,
corynebacterium_oculi	marinactinospora_thermotolerans	pro__L_e,
marinactinospora_thermotolerans	corynebacterium_oculi	h2o_e,h_e,h2s_e,
corynebacterium_phocae	verminephrobacter_aporrectodeae	
verminephrobacter_aporrectodeae	corynebacterium_phocae	
corynebacterium_pseudotuberculosis	granulicella_rosea	asp__L_e,h2s_e,
granulicella_rosea	corynebacterium_pseudotuberculosis	h2o_e,
corynebacterium_riegelii	lysobacter_defluvii	pi_e,hxan_e,
lysobacter_defluvii	corynebacterium_riegelii	ala__L_e,
corynebacterium_riegelii	rhizobium_leguminosarum	pi_e,fe3_e,
rhizobium_leguminosarum	corynebacterium_riegelii	
corynebacterium_singulare	nocardioides_exalbidus	
nocardioides_exalbidus	corynebacterium_singulare	pi_e,
corynebacterium_sphenisci	kitasatospora_setae	ala__L_e,ade_e,
kitasatospora_setae	corynebacterium_sphenisci	gly_e,
corynebacterium_stationis	lactobacillus_paracasei	icit_e,ade_e,
lactobacillus_paracasei	corynebacterium_stationis	val__L_e,gly_e,
corynebacterium_terpenotabidum	metallibacterium_scheffleri	pyr_e,
metallibacterium_scheffleri	corynebacterium_terpenotabidum	
corynebacterium_testudinoris	lactobacillus_jensenii	nh4_e,
lactobacillus_jensenii	corynebacterium_testudinoris	h2o_e,h_e,trp__L_e,
corynebacterium_ulceribovis	nonlabens_spongiae	nh4_e,hxan_e,
nonlabens_spongiae	corynebacterium_ulceribovis	val__L_e,
corynebacterium_urealyticum	kocuria_salsicia	
kocuria_salsicia	corynebacterium_urealyticum	4abut_e,
corynebacterium_variabile	thermobifida_fusca	h2o_e,
thermobifida_fusca	corynebacterium_variabile	for_e,
crenobacter_luteus	nesterenkonia_jeotgali	acald_e,h2o_e,
nesterenkonia_jeotgali	crenobacter_luteus	pi_e,cu2_e,
crenotalea_thermophila	tateyamaria_omphalii	
tateyamaria_omphalii	crenotalea_thermophila	
cribrihabitans_marinus	ruegeria_halocynthiae	
ruegeria_halocynthiae	cribrihabitans_marinus	ala__L_e,orn_e,
croceibacter_atlanticus	thermanaerovibrio_velox	nh4_e,orn_e,
thermanaerovibrio_velox	croceibacter_atlanticus	h2o_e,pyr_e,h2s_e,
croceicoccus_mobilis	thermus_islandicus	
thermus_islandicus	croceicoccus_mobilis	nh4_e,ala__L_e,
croceicoccus_naphthovorans	phenylobacterium_zucineum	h2o_e,glu__L_e,acald_e,
phenylobacterium_zucineum	croceicoccus_naphthovorans	
croceicoccus_pelagius	lactobacillus_equigenerosi	
lactobacillus_equigenerosi	croceicoccus_pelagius	h2o_e,
cryobacterium_roopkundense	kutzneria_albida	h2o_e,lac__L_e,
kutzneria_albida	cryobacterium_roopkundense	akg_e,
cryptobacterium_curtum	polaribacter_haliotis	pi_e,
polaribacter_haliotis	cryptobacterium_curtum	
cucumibacter_marinus	salinispora_tropica	
salinispora_tropica	cucumibacter_marinus	
culturomica_massiliensis	peptoclostridium_acidaminophilum	h2o_e,pi_e,fe2_e,
peptoclostridium_acidaminophilum	culturomica_massiliensis	nh4_e,
cupriavidus_basilensis	geminocystis_herdmanii	h2s_e,
geminocystis_herdmanii	cupriavidus_basilensis	
cupriavidus_gilardii	luteipulveratus_mongoliensis	fum_e,h2o_e,
luteipulveratus_mongoliensis	cupriavidus_gilardii	
cupriavidus_metallidurans	fulvimarina_manganoxydans	acald_e,gua_e,
fulvimarina_manganoxydans	cupriavidus_metallidurans	h2o_e,fe3_e,
curtobacterium_ammoniigenes	leptospira_kmetyi	h2o_e,pi_e,bz_e,
leptospira_kmetyi	curtobacterium_ammoniigenes	
curtobacterium_pusillum	exiguobacterium_sibiricum	no2_e,h2o_e,
exiguobacterium_sibiricum	curtobacterium_pusillum	acald_e,
cyanobacterium_endosymbiont	nocardia_niwae	nh4_e,h_e,
nocardia_niwae	cyanobacterium_endosymbiont	leu__L_e,
cyclobacterium_halophilum	mariniphaga_anaerophila	ser__D_e,nh4_e,h2s_e,
mariniphaga_anaerophila	cyclobacterium_halophilum	
cyclobacterium_lianum	mycoplasma_putrefaciens	h2s_e,
mycoplasma_putrefaciens	cyclobacterium_lianum	h2o_e,asp__L_e,succ_e,
cyclobacterium_marinum	lentisphaera_araneosa	glu__L_e,
lentisphaera_araneosa	cyclobacterium_marinum	cgly_e,
cyclobacterium_qasimii	novosphingobium_malaysiense	h_e,
novosphingobium_malaysiense	cyclobacterium_qasimii	ser__D_e,fe2_e,
cystobacter_fuscus	lactobacillus_herbarum	
lactobacillus_herbarum	cystobacter_fuscus	
cytophaga_hutchinsonii	oceanobacillus_iheyensis	nh4_e,cgly_e,
oceanobacillus_iheyensis	cytophaga_hutchinsonii	gly_e,
dactylococcopsis_salina	frankia_casuarinae	h2o_e,nh4_e,h2s_e,
frankia_casuarinae	dactylococcopsis_salina	
dechloromonas_aromatica	rhodovibrio_salinarum	h2o_e,
rhodovibrio_salinarum	dechloromonas_aromatica	nh4_e,no2_e,
deferribacter_desulfuricans	filimonas_lacunae	pi_e,
filimonas_lacunae	deferribacter_desulfuricans	
defluviitalea_phaphyphila	desulfotomaculum_arcticum	akg_e,acald_e,
desulfotomaculum_arcticum	defluviitalea_phaphyphila	h_e,ura_e,h2s_e,
dehalogenimonas_formicexedens	rhizobium_favelukesii	nh4_e,
rhizobium_favelukesii	dehalogenimonas_formicexedens	h2o_e,h2s_e,fe2_e,
deinococcus_apachensis	thermogemmatispora_carboxidivorans	
thermogemmatispora_carboxidivorans	deinococcus_apachensis	pi_e,
deinococcus_deserti	planomicrobium_flavidum	
planomicrobium_flavidum	deinococcus_deserti	nh4_e,
deinococcus_gobiensis	pseudomonas_litoralis	
pseudomonas_litoralis	deinococcus_gobiensis	nh4_e,ade_e,for_e,
deinococcus_hopiensis	ilumatobacter_coccineus	h_e,
ilumatobacter_coccineus	deinococcus_hopiensis	h2o_e,glyc_e,
deinococcus_maricopensis	mycobacterium_insubricum	h2o_e,
mycobacterium_insubricum	deinococcus_maricopensis	h2s_e,
deinococcus_peraridilitoris	stigmatella_aurantiaca	nh4_e,pi_e,
stigmatella_aurantiaca	deinococcus_peraridilitoris	
deinococcus_pimensis	nitriliruptor_alkaliphilus	
nitriliruptor_alkaliphilus	deinococcus_pimensis	h2o_e,acald_e,
deinococcus_proteolyticus	pararhodospirillum_photometricum	pyr_e,
pararhodospirillum_photometricum	deinococcus_proteolyticus	h2s_e,
deinococcus_puniceus	ponticaulis_koreensis	
ponticaulis_koreensis	deinococcus_puniceus	fe2_e,
deinococcus_puniceus	streptomyces_rubidus	nh4_e,fe3_e,orn_e,cu2_e,
streptomyces_rubidus	deinococcus_puniceus	h2o_e,fe2_e,pi_e,
deinococcus_radiodurans	listeria_weihenstephanensis	glu__L_e,nh4_e,
listeria_weihenstephanensis	deinococcus_radiodurans	acald_e,fe2_e,
deinococcus_reticulitermitis	micromonospora_coxensis	nh4_e,glyclt_e,
micromonospora_coxensis	deinococcus_reticulitermitis	
deinococcus_swuensis	lewinella_agarilytica	h2o_e,fe2_e,
lewinella_agarilytica	deinococcus_swuensis	pi_e,
deinococcus_wulumuqiensis	zhouia_amylolytica	h2o_e,
zhouia_amylolytica	deinococcus_wulumuqiensis	acald_e,no2_e,fe2_e,cu2_e,
demequina_lutea	rhodoblastus_acidophilus	h_e,glyc_e,
rhodoblastus_acidophilus	demequina_lutea	orn_e,
denitrobacterium_detoxificans	desulfotomaculum_ruminis	h2o_e,fe2_e,
desulfotomaculum_ruminis	denitrobacterium_detoxificans	acald_e,pro__L_e,
denitrovibrio_acetiphilus	lysinimicrobium_flavum	h2s_e,
lysinimicrobium_flavum	denitrovibrio_acetiphilus	nh4_e,ade_e,
dermabacter_vaginalis	streptomyces_lincolnensis	nh4_e,
streptomyces_lincolnensis	dermabacter_vaginalis	etoh_e,
desulfamplus_magnetovallimortis	hydrobacter_penzbergensis	nh4_e,
hydrobacter_penzbergensis	desulfamplus_magnetovallimortis	pi_e,
desulfamplus_magnetovallimortis	rubritalea_marina	
rubritalea_marina	desulfamplus_magnetovallimortis	pi_e,
desulfatitalea_tepidiphila	desulfovibrio_africanus	
desulfovibrio_africanus	desulfatitalea_tepidiphila	
desulfitobacterium_dehalogenans	paenibacillus_taiwanensis	asp__L_e,ade_e,
paenibacillus_taiwanensis	desulfitobacterium_dehalogenans	h2o_e,val__L_e,
desulfitobacterium_dichloroeliminans	wolbachia_endosymbiont	gly_e,no2_e,no2_e,no2_e,no2_e,glu__L_e,glu__L_e,pi_e,ade_e,h2s_e,h2s_e,h2s_e,
wolbachia_endosymbiont	desulfitobacterium_dichloroeliminans	ala__L_e,ala__L_e,ala__L_e,ala__L_e,
desulfitobacterium_metallireducens	lachnospiraceae_bacterium	ura_e,
lachnospiraceae_bacterium	desulfitobacterium_metallireducens	nh4_e,h2o_e,
desulfobacca_acetoxidans	syntrophomonas_palmitatica	
syntrophomonas_palmitatica	desulfobacca_acetoxidans	h2o_e,
desulfobacterium_autotrophicum	thermovenabulum_gondwanense	h2o_e,
thermovenabulum_gondwanense	desulfobacterium_autotrophicum	pi_e,
desulfobacter_postgatei	marivita_geojedonensis	h2o_e,cu2_e,
marivita_geojedonensis	desulfobacter_postgatei	nh4_e,h2s_e,
desulfobacula_toluolica	wolinella_succinogenes	
wolinella_succinogenes	desulfobacula_toluolica	pi_e,fe2_e,
desulfocapsa_sulfexigens	herbaspirillum_seropedicae	
herbaspirillum_seropedicae	desulfocapsa_sulfexigens	glu__L_e,
desulfocarbo_indianensis	rhodospirillum_rubrum	
rhodospirillum_rubrum	desulfocarbo_indianensis	nh4_e,
desulfococcus_multivorans	lachnospiraceae_bacterium	ura_e,
lachnospiraceae_bacterium	desulfococcus_multivorans	nh4_e,fum_e,
desulfococcus_multivorans	ruminococcaceae_bacterium	fe2_e,
ruminococcaceae_bacterium	desulfococcus_multivorans	
desulfocurvus_vexinensis	lihuaxuella_thermophila	
lihuaxuella_thermophila	desulfocurvus_vexinensis	h2o_e,
desulfohalobium_retbaense	desulfovibrio_gigas	h2s_e,
desulfovibrio_gigas	desulfohalobium_retbaense	h2o_e,
desulfohalobium_retbaense	novibacillus_thermophilus	
novibacillus_thermophilus	desulfohalobium_retbaense	
desulfomicrobium_baculatum	rhodoferax_ferrireducens	pyr_e,
rhodoferax_ferrireducens	desulfomicrobium_baculatum	pi_e,
desulfomicrobium_orale	desulfovirgula_thermocuniculi	
desulfovirgula_thermocuniculi	desulfomicrobium_orale	pro__L_e,
desulfomonile_tiedjei	echinicola_pacifica	pi_e,
echinicola_pacifica	desulfomonile_tiedjei	h_e,h2o_e,h2s_e,fe2_e,
desulfomonile_tiedjei	halomonas_korlensis	
halomonas_korlensis	desulfomonile_tiedjei	nh4_e,
desulfomonile_tiedjei	syntrophus_aciditrophicus	gua_e,
syntrophus_aciditrophicus	desulfomonile_tiedjei	
desulfonatronospira_thiodismutans	rudaea_cellulosilytica	
rudaea_cellulosilytica	desulfonatronospira_thiodismutans	
desulfonatronovibrio_magnus	rhodobacter_aestuarii	h2o_e,
rhodobacter_aestuarii	desulfonatronovibrio_magnus	acald_e,fum_e,nh4_e,h2s_e,
desulfonatronum_thioautotrophicum	paenibacillus_tianmuensis	
paenibacillus_tianmuensis	desulfonatronum_thioautotrophicum	h2o_e,
desulfonatronum_thiosulfatophilum	ruegeria_pomeroyi	pyr_e,
ruegeria_pomeroyi	desulfonatronum_thiosulfatophilum	nh4_e,
desulfosporosinus_acididurans	salinicoccus_albus	h2o_e,nh4_e,glyclt_e,
salinicoccus_albus	desulfosporosinus_acididurans	asp__L_e,leu__L_e,gly_e,val__L_e,pro__L_e,acald_e,
desulfosporosinus_acididurans	thermoanaerobacterium_xylanolyticum	glyclt_e,
thermoanaerobacterium_xylanolyticum	desulfosporosinus_acididurans	acald_e,gly_e,leu__L_e,h2s_e,
desulfosporosinus_lacus	paenibacillus_yonginensis	ser__L_e,
paenibacillus_yonginensis	desulfosporosinus_lacus	acald_e,
desulfosporosinus_meridiei	phycisphaera_mikurensis	fe2_e,
phycisphaera_mikurensis	desulfosporosinus_meridiei	
desulfosporosinus_orientis	proteiniborus_ethanoligenes	pi_e,ura_e,
proteiniborus_ethanoligenes	desulfosporosinus_orientis	h2o_e,pro__L_e,fe2_e,
desulfotalea_psychrophila	pseudodesulfovibrio_piezophilus	
pseudodesulfovibrio_piezophilus	desulfotalea_psychrophila	
desulfotomaculum_acetoxidans	desulfotomaculum_gibsoniae	h_e,
desulfotomaculum_gibsoniae	desulfotomaculum_acetoxidans	acald_e,nh4_e,pro__L_e,
desulfotomaculum_acetoxidans	desulfotomaculum_nigrificans	h_e,
desulfotomaculum_nigrificans	desulfotomaculum_acetoxidans	acald_e,pi_e,
desulfotomaculum_copahuensis	oscillatoriales_cyanobacterium	
oscillatoriales_cyanobacterium	desulfotomaculum_copahuensis	
desulfotomaculum_copahuensis	paenibacillus_algorifonticola	acald_e,
paenibacillus_algorifonticola	desulfotomaculum_copahuensis	h2o_e,h_e,
desulfotomaculum_ferrireducens	flexibacter_flexilis	nh4_e,h_e,mal__L_e,
flexibacter_flexilis	desulfotomaculum_ferrireducens	pi_e,val__L_e,
desulfotomaculum_ferrireducens	lactobacillus_agilis	nh4_e,h_e,
lactobacillus_agilis	desulfotomaculum_ferrireducens	h2o_e,val__L_e,h2s_e,
desulfotomaculum_hydrothermale	stenotrophomonas_panacihumi	no2_e,asp__L_e,
stenotrophomonas_panacihumi	desulfotomaculum_hydrothermale	pi_e,h2s_e,
desulfotomaculum_intricatum	mycobacterium_litorale	pi_e,
mycobacterium_litorale	desulfotomaculum_intricatum	fe2_e,
desulfotomaculum_thermosubterraneum	microbulbifer_agarilyticus	h2o_e,
microbulbifer_agarilyticus	desulfotomaculum_thermosubterraneum	h2s_e,pro__L_e,
desulfovermiculus_halophilus	immundisolibacter_cernigliae	nh4_e,
immundisolibacter_cernigliae	desulfovermiculus_halophilus	glyc_e,
desulfovermiculus_halophilus	robiginitomaculum_antarcticum	gly_e,
robiginitomaculum_antarcticum	desulfovermiculus_halophilus	pi_e,glyc_e,
desulfovibrio_alaskensis	pseudogulbenkiania_subflava	
pseudogulbenkiania_subflava	desulfovibrio_alaskensis	
desulfovibrio_bizertensis	phaeospirillum_molischianum	pi_e,
phaeospirillum_molischianum	desulfovibrio_bizertensis	
desulfovibrio_bizertensis	roseomonas_stagni	pi_e,
roseomonas_stagni	desulfovibrio_bizertensis	
desulfovibrio_bizertensis	thermomonospora_curvata	pi_e,glu__L_e,
thermomonospora_curvata	desulfovibrio_bizertensis	
desulfovibrio_desulfuricans	methylobacterium_nodulans	
methylobacterium_nodulans	desulfovibrio_desulfuricans	pyr_e,h2s_e,
desulfovibrio_fructosivorans	microbacterium_yannicii	fe3_e,
microbacterium_yannicii	desulfovibrio_fructosivorans	nh4_e,
desulfovibrio_fructosivorans	patulibacter_medicamentivorans	no2_e,
patulibacter_medicamentivorans	desulfovibrio_fructosivorans	pi_e,
desulfovibrio_hydrothermalis	nodosilinea_nodulosa	gthrd_e,
nodosilinea_nodulosa	desulfovibrio_hydrothermalis	nh4_e,glyc_e,
desulfovibrio_legallii	enterorhabdus_mucosicola	acald_e,
enterorhabdus_mucosicola	desulfovibrio_legallii	h2o_e,so3_e,pi_e,ura_e,
desulfovibrio_legallii	hymenobacter_sedentarius	no2_e,acald_e,fe2_e,
hymenobacter_sedentarius	desulfovibrio_legallii	h2o_e,pi_e,h2s_e,
desulfovibrio_legallii	moorella_thermoacetica	no2_e,
moorella_thermoacetica	desulfovibrio_legallii	glyclt_e,
desulfovibrio_legallii	paenibacillus_pinihumi	acald_e,pro__L_e,
paenibacillus_pinihumi	desulfovibrio_legallii	
desulfovibrio_legallii	ruminococcaceae_bacterium	acald_e,fe2_e,
ruminococcaceae_bacterium	desulfovibrio_legallii	ura_e,
desulfovibrio_longus	novosphingobium_barchaimii	h2o_e,
novosphingobium_barchaimii	desulfovibrio_longus	acald_e,pro__L_e,
desulfovibrio_magneticus	pontibacter_akesuensis	asp__L_e,
pontibacter_akesuensis	desulfovibrio_magneticus	pro__L_e,
desulfovibrio_salexigens	parvularcula_oceani	h2o_e,h_e,fe3_e,cu2_e,
parvularcula_oceani	desulfovibrio_salexigens	acald_e,
desulfovibrio_vulgaris	stenotrophomonas_ginsengisoli	pi_e,
stenotrophomonas_ginsengisoli	desulfovibrio_vulgaris	
desulfovirgula_thermocuniculi	geoalkalibacter_subterraneus	h2o_e,
geoalkalibacter_subterraneus	desulfovirgula_thermocuniculi	nh4_e,pi_e,
desulfovirgula_thermocuniculi	tessaracoccus_oleiagri	no2_e,ade_e,h2o_e,
tessaracoccus_oleiagri	desulfovirgula_thermocuniculi	
desulfovirgula_thermocuniculi	tetragenococcus_halophilus	ade_e,h2o_e,
tetragenococcus_halophilus	desulfovirgula_thermocuniculi	nh4_e,pi_e,
desulfurella_amilsii	longilinea_arvoryzae	glu__L_e,
longilinea_arvoryzae	desulfurella_amilsii	
desulfuribacillus_alkaliarsenatis	thermovenabulum_gondwanense	
thermovenabulum_gondwanense	desulfuribacillus_alkaliarsenatis	
desulfuribacillus_stibiiarsenatis	magnetospirillum_caucaseum	pi_e,
magnetospirillum_caucaseum	desulfuribacillus_stibiiarsenatis	
desulfurivibrio_alkaliphilus	skermanella_stibiiresistens	pi_e,
skermanella_stibiiresistens	desulfurivibrio_alkaliphilus	h2o_e,
desulfurobacterium_indicum	leptospirillum_ferriphilum	h2o_e,glyclt_e,h2s_e,fe2_e,
leptospirillum_ferriphilum	desulfurobacterium_indicum	pyr_e,
desulfurobacterium_indicum	phaeobacter_porticola	
phaeobacter_porticola	desulfurobacterium_indicum	nh4_e,
desulfurobacterium_thermolithotrophum	mycoplasma_conjunctivae	dad_2_e,
mycoplasma_conjunctivae	desulfurobacterium_thermolithotrophum	
desulfurobacterium_thermolithotrophum	sulfitobacter_marinus	h2o_e,
sulfitobacter_marinus	desulfurobacterium_thermolithotrophum	
desulfuromonas_soudanensis	gottschalkia_acidurici	ura_e,
gottschalkia_acidurici	desulfuromonas_soudanensis	nh4_e,
dethiosulfovibrio_peptidovorans	sphingomonas_indica	ala__L_e,
sphingomonas_indica	dethiosulfovibrio_peptidovorans	ade_e,
dethiosulfovibrio_salsuginis	thermanaerovibrio_velox	ala__L_e,
thermanaerovibrio_velox	dethiosulfovibrio_salsuginis	h_e,pyr_e,asp__L_e,pro__L_e,fe2_e,
devosia_chinhatensis	mesoplasma_florum	
mesoplasma_florum	devosia_chinhatensis	pi_e,co2_e,
devosia_enhydra	marinithermus_hydrothermalis	no2_e,
marinithermus_hydrothermalis	devosia_enhydra	nh4_e,pi_e,gua_e,
devosia_epidermidihirudinis	wenxinia_saemankumensis	h2s_e,
wenxinia_saemankumensis	devosia_epidermidihirudinis	h2o_e,nh4_e,
devosia_geojensis	thioalkalivibrio_sulfidiphilus	h_e,ala__D_e,cgly_e,cu2_e,
thioalkalivibrio_sulfidiphilus	devosia_geojensis	h2o_e,nh4_e,
devosia_psychrophila	microbacterium_luticocti	fe3_e,cu2_e,
microbacterium_luticocti	devosia_psychrophila	
devosia_psychrophila	pirellula_staleyi	fe2_e,
pirellula_staleyi	devosia_psychrophila	
devosia_psychrophila	sinomonas_mesophila	acald_e,
sinomonas_mesophila	devosia_psychrophila	
devosia_psychrophila	streptomyces_gilvigriseus	acald_e,
streptomyces_gilvigriseus	devosia_psychrophila	
dialister_micraerophilus	prevotella_enoeca	no2_e,ura_e,
prevotella_enoeca	dialister_micraerophilus	h2o_e,pi_e,
dialister_succinatiphilus	dubosiella_newyorkensis	
dubosiella_newyorkensis	dialister_succinatiphilus	asp__L_e,pi_e,pro__L_e,
dialister_succinatiphilus	faecalicoccus_pleomorphus	nh4_e,fum_e,
faecalicoccus_pleomorphus	dialister_succinatiphilus	asp__L_e,val__L_e,no2_e,succ_e,
dichelobacter_nodosus	rhizobium_rhizosphaerae	arab__D_e,fe3_e,
rhizobium_rhizosphaerae	dichelobacter_nodosus	h2s_e,
dickeya_solani	serratia_rubidaea	gua_e,
serratia_rubidaea	dickeya_solani	
dictyoglomus_thermophilum	parafilimonas_terrae	h2o_e,
parafilimonas_terrae	dictyoglomus_thermophilum	
dictyoglomus_turgidum	loktanella_cinnabarina	glu__L_e,nh4_e,fe3_e,h2s_e,
loktanella_cinnabarina	dictyoglomus_turgidum	acald_e,
dietzia_alimentaria	lysinimicrobium_pelophilum	gthox_e,ala__L_e,
lysinimicrobium_pelophilum	dietzia_alimentaria	h2o_e,gthrd_e,h2o2_e,pi_e,
dietzia_timorensis	paenibacillus_barengoltzii	pnto__R_e,
paenibacillus_barengoltzii	dietzia_timorensis	h2o_e,
dinoroseobacter_shibae	sphingomonas_dokdonensis	bz_e,
sphingomonas_dokdonensis	dinoroseobacter_shibae	
dissulfuribacter_thermophilus	methyloceanibacter_caenitepidi	asp__L_e,fe3_e,
methyloceanibacter_caenitepidi	dissulfuribacter_thermophilus	pyr_e,h2o_e,pi_e,h2s_e,
dissulfuribacter_thermophilus	spiroplasma_helicoides	
spiroplasma_helicoides	dissulfuribacter_thermophilus	h2o_e,h_e,succ_e,
dokdonella_koreensis	pontibacter_actiniarum	h2o_e,bz_e,
pontibacter_actiniarum	dokdonella_koreensis	h_e,
dokdonia_pacifica	octadecabacter_temperatus	glu__L_e,pi_e,
octadecabacter_temperatus	dokdonia_pacifica	h_e,
domibacillus_indicus	lachnospiraceae_bacterium	
lachnospiraceae_bacterium	domibacillus_indicus	nh4_e,no2_e,cgly_e,
draconibacterium_orientale	sphingobacterium_paucimobilis	
sphingobacterium_paucimobilis	draconibacterium_orientale	asp__L_e,
draconibacterium_orientale	vibrio_scophthalmi	nh4_e,
vibrio_scophthalmi	draconibacterium_orientale	
dyadobacter_alkalitolerans	geoalkalibacter_ferrihydriticus	
geoalkalibacter_ferrihydriticus	dyadobacter_alkalitolerans	
dyadobacter_fermentans	rufibacter_ruber	pi_e,
rufibacter_ruber	dyadobacter_fermentans	
dyadobacter_koreensis	endomicrobium_proavitum	fe2_e,
endomicrobium_proavitum	dyadobacter_koreensis	h2o_e,h2s_e,
dyadobacter_tibetensis	planctopirus_limnophila	h2o_e,
planctopirus_limnophila	dyadobacter_tibetensis	
dyadobacter_tibetensis	rufibacter_roseus	glu__L_e,pi_e,fe2_e,
rufibacter_roseus	dyadobacter_tibetensis	
dyella_japonica	kineococcus_radiotolerans	fum_e,glyc_e,orn_e,
kineococcus_radiotolerans	dyella_japonica	h2o_e,h_e,fe2_e,
dyella_thiooxydans	massilia_yuzhufengensis	
massilia_yuzhufengensis	dyella_thiooxydans	h2o_e,
dysgonomonas_macrotermitis	patulibacter_americanus	nh4_e,
patulibacter_americanus	dysgonomonas_macrotermitis	ade_e,h2s_e,
dysgonomonas_macrotermitis	salinimicrobium_xinjiangense	nh4_e,pi_e,
salinimicrobium_xinjiangense	dysgonomonas_macrotermitis	glu__L_e,h2s_e,
echinicola_vietnamensis	methylobrevis_pamukkalensis	pi_e,no2_e,
methylobrevis_pamukkalensis	echinicola_vietnamensis	
ectothiorhodospira_magna	sedimentitalea_nanhaiensis	pi_e,fe3_e,cu2_e,
sedimentitalea_nanhaiensis	ectothiorhodospira_magna	nh4_e,
edaphobacillus_lindanitolerans	polymorphum_gilvum	pi_e,
polymorphum_gilvum	edaphobacillus_lindanitolerans	nh4_e,
edaphobacillus_lindanitolerans	rhodospirillum_centenum	pi_e,
rhodospirillum_centenum	edaphobacillus_lindanitolerans	nh4_e,
edwardsiella_anguillarum	enterobacter_cloacae	
enterobacter_cloacae	edwardsiella_anguillarum	
eggerthella_lenta	lachnospiraceae_bacterium	ura_e,
lachnospiraceae_bacterium	eggerthella_lenta	nh4_e,ade_e,
eggerthella_lenta	mageeibacillus_indolicus	4abz_e,
mageeibacillus_indolicus	eggerthella_lenta	ala__L_e,h2s_e,
eisenibacter_elegans	nafulsella_turpanensis	h_e,
nafulsella_turpanensis	eisenibacter_elegans	
eisenibacter_elegans	niabella_drilacis	glu__L_e,pi_e,
niabella_drilacis	eisenibacter_elegans	pyr_e,
eisenibacter_elegans	parapedobacter_indicus	h_e,pi_e,
parapedobacter_indicus	eisenibacter_elegans	ala__L_e,
eisenibacter_elegans	photobacterium_swingsii	pi_e,
photobacterium_swingsii	eisenibacter_elegans	acald_e,etoh_e,
eisenibacter_elegans	starkeya_novella	
starkeya_novella	eisenibacter_elegans	
ekhidna_lutea	virgibacillus_halodenitrificans	pi_e,nh4_e,
virgibacillus_halodenitrificans	ekhidna_lutea	gly_e,
elioraea_tepidiphila	roseomonas_cervicalis	pyr_e,
roseomonas_cervicalis	elioraea_tepidiphila	
elizabethkingia_anophelis	niastella_koreensis	
niastella_koreensis	elizabethkingia_anophelis	
endomicrobium_proavitum	salisediminibacterium_haloalkalitolerans	glyclt_e,pi_e,
salisediminibacterium_haloalkalitolerans	endomicrobium_proavitum	fe2_e,
trimyema_compressum	labilibacter_marinus	
labilibacter_marinus	trimyema_compressum	
ensifer_sojae	propionibacterium_acidifaciens	
propionibacterium_acidifaciens	ensifer_sojae	
enterobacter_cloacae	fabibacter_misakiensis	
fabibacter_misakiensis	enterobacter_cloacae	
enterobacter_cloacae	methyloligella_halotolerans	
methyloligella_halotolerans	enterobacter_cloacae	
enterobacter_cloacae	piscirickettsia_litoralis	
piscirickettsia_litoralis	enterobacter_cloacae	
enterobacter_cloacae	enterococcus_massiliensis	
enterococcus_massiliensis	enterobacter_cloacae	
enterobacter_cloacae	enterobacter_cloacae	
enterobacter_cloacae	enterobacter_cloacae	
enterobacter_cloacae	vibrio_cholerae	
vibrio_cholerae	enterobacter_cloacae	
enterobacter_cloacae	parasaccharibacter_apium	
parasaccharibacter_apium	enterobacter_cloacae	
enterobacter_cloacae	youngiibacter_fragilis	
youngiibacter_fragilis	enterobacter_cloacae	
enterobacter_cloacae	petrimonas_mucosa	
petrimonas_mucosa	enterobacter_cloacae	
enterobacter_cloacae	geofilum_rubicundum	
geofilum_rubicundum	enterobacter_cloacae	
enterobacter_cloacae	pontibacter_roseus	
pontibacter_roseus	enterobacter_cloacae	
enterobacter_cloacae	pseudarcicella_hirudinis	
pseudarcicella_hirudinis	enterobacter_cloacae	
enterobacter_cloacae	plesiocystis_pacifica	
plesiocystis_pacifica	enterobacter_cloacae	
enterobacter_cloacae	enterobacter_kobei	
enterobacter_kobei	enterobacter_cloacae	
enterobacter_cloacae	enterobacter_cloacae	
enterobacter_cloacae	enterobacter_cloacae	
enterobacter_cloacae	enterococcus_thailandicus	
enterococcus_thailandicus	enterobacter_cloacae	
enterobacter_cloacae	franconibacter_pulveris	
franconibacter_pulveris	enterobacter_cloacae	
enterobacter_cloacae	vibrio_proteolyticus	
vibrio_proteolyticus	enterobacter_cloacae	
enterobacter_cloacae	wolbachia_endosymbiont	
wolbachia_endosymbiont	enterobacter_cloacae	
enterobacter_cloacae	pedobacter_luteus	
pedobacter_luteus	enterobacter_cloacae	
enterobacter_cloacae	enterobacter_cloacae	
enterobacter_cloacae	enterobacter_cloacae	
enterobacter_cloacae	enterobacter_cloacae	
enterobacter_cloacae	enterobacter_cloacae	
enterobacter_cloacae	geobacter_metallireducens	
geobacter_metallireducens	enterobacter_cloacae	
enterobacter_cloacae	mycobacterium_aurum	
mycobacterium_aurum	enterobacter_cloacae	
enterobacter_cloacae	idiomarina_woesei	
idiomarina_woesei	enterobacter_cloacae	
enterobacter_cloacae	helicobacter_fennelliae	
helicobacter_fennelliae	enterobacter_cloacae	
enterobacter_cloacae	enterovibrio_pacificus	
enterovibrio_pacificus	enterobacter_cloacae	
enterobacter_cloacae	komagataeibacter_xylinus	
komagataeibacter_xylinus	enterobacter_cloacae	
enterobacter_cloacae	legionella_longbeachae	
legionella_longbeachae	enterobacter_cloacae	
enterobacter_cloacae	plesiomonas_shigelloides	
plesiomonas_shigelloides	enterobacter_cloacae	
enterobacter_cloacae	flavobacterium_gilvum	
flavobacterium_gilvum	enterobacter_cloacae	
enterobacter_cloacae	novosphingobium_acidiphilum	
novosphingobium_acidiphilum	enterobacter_cloacae	
enterococcus_aquimarinus	kurthia_massiliensis	pi_e,
kurthia_massiliensis	enterococcus_aquimarinus	
enterococcus_aquimarinus	tolumonas_auensis	pi_e,
tolumonas_auensis	enterococcus_aquimarinus	acald_e,
enterovibrio_nigricans	photobacterium_aquae	pi_e,
photobacterium_aquae	enterovibrio_nigricans	
erwinia_oleae	nocardia_brasiliensis	
nocardia_brasiliensis	erwinia_oleae	asp__L_e,
erysipelothrix_larvae	peptoniphilus_lacrimalis	
peptoniphilus_lacrimalis	erysipelothrix_larvae	h_e,h2o_e,fe2_e,
erythrobacter_atlanticus	thermosediminibacter_oceani	
thermosediminibacter_oceani	erythrobacter_atlanticus	gly_e,gly_e,
erythrobacter_longus	marinovum_algicola	pi_e,
marinovum_algicola	erythrobacter_longus	h2o_e,nh4_e,
erythrobacter_luteus	fibrella_aestuarina	pi_e,
fibrella_aestuarina	erythrobacter_luteus	h2o_e,
erythrobacter_marinus	marine_actinobacterium	glu__L_e,
marine_actinobacterium	erythrobacter_marinus	
erythrobacter_nanhaisediminis	paracoccus_sphaerophysae	
paracoccus_sphaerophysae	erythrobacter_nanhaisediminis	
ethanoligenens_harbinense	ruminococcaceae_bacterium	nh4_e,acald_e,fe2_e,
ruminococcaceae_bacterium	ethanoligenens_harbinense	gly_e,
fabibacter_pacificus	haliscomenobacter_hydrossis	pyr_e,fe3_e,
haliscomenobacter_hydrossis	fabibacter_pacificus	
fenollaria_massiliensis	flavobacterium_daejeonense	h2o_e,ala__L_e,for_e,
flavobacterium_daejeonense	fenollaria_massiliensis	nh4_e,thym_e,fe2_e,
ferrimonas_senticii	rheinheimera_nanhaiensis	no2_e,lac__D_e,
rheinheimera_nanhaiensis	ferrimonas_senticii	nh4_e,
fervidicola_ferrireducens	pediococcus_acidilactici	nh4_e,glu__L_e,orn_e,
pediococcus_acidilactici	fervidicola_ferrireducens	h2o_e,h_e,val__L_e,
fervidobacterium_pennivorans	halobacillus_massiliensis	h_e,
halobacillus_massiliensis	fervidobacterium_pennivorans	
fibrella_aestuarina	mariniradius_saccharolyticus	
mariniradius_saccharolyticus	fibrella_aestuarina	
fibrobacter_succinogenes	streptomyces_jeddahensis	nh4_e,cu2_e,
streptomyces_jeddahensis	fibrobacter_succinogenes	acald_e,
fictibacillus_enclensis	hydrocarboniphaga_daqingensis	gly_e,
hydrocarboniphaga_daqingensis	fictibacillus_enclensis	glyc_e,
fictibacillus_enclensis	virgibacillus_necropolis	trp__L_e,
virgibacillus_necropolis	fictibacillus_enclensis	acald_e,pi_e,
filamentous_cyanobacterium	micromonospora_avicenniae	
micromonospora_avicenniae	filamentous_cyanobacterium	
filimonas_lacunae	mucilaginibacter_pineti	h_e,
mucilaginibacter_pineti	filimonas_lacunae	pi_e,
fimbriiglobus_ruber	nisaea_denitrificans	
nisaea_denitrificans	fimbriiglobus_ruber	
fimbriimonas_ginsengisoli	uliginosibacterium_gangwonense	h_e,
uliginosibacterium_gangwonense	fimbriimonas_ginsengisoli	
flagellimonas_eckloniae	hyunsoonleella_jejuensis	pi_e,h2s_e,
hyunsoonleella_jejuensis	flagellimonas_eckloniae	h_e,
flaviflexus_massiliensis	rubidibacter_lacunae	nh4_e,gly_e,h2s_e,
rubidibacter_lacunae	flaviflexus_massiliensis	
flavihumibacter_petaseus	rhodohalobacter_halophilus	h_e,asp__L_e,pi_e,
rhodohalobacter_halophilus	flavihumibacter_petaseus	nh4_e,h2s_e,
flavihumibacter_petaseus	saccharicrinis_fermentans	
saccharicrinis_fermentans	flavihumibacter_petaseus	nh4_e,h2s_e,
flavihumibacter_solisilvae	glaciecola_nitratireducens	h2o_e,h2s_e,for_e,
glaciecola_nitratireducens	flavihumibacter_solisilvae	pi_e,
flaviramulus_basaltis	fluoribacter_dumoffii	h2o_e,h_e,pi_e,fe2_e,
fluoribacter_dumoffii	flaviramulus_basaltis	acald_e,
flavisolibacter_ginsengisoli	flavobacterium_sasangense	pyr_e,adn_e,h2s_e,
flavobacterium_sasangense	flavisolibacter_ginsengisoli	h2o_e,glu__L_e,for_e,fe2_e,
flavobacterium_beibuense	flectobacillus_major	pi_e,
flectobacillus_major	flavobacterium_beibuense	
flavobacterium_branchiophilum	providencia_alcalifaciens	for_e,
providencia_alcalifaciens	flavobacterium_branchiophilum	
flavobacterium_cauense	lactobacillus_wasatchensis	glu__L_e,for_e,
lactobacillus_wasatchensis	flavobacterium_cauense	acald_e,
flavobacterium_columnare	spirosoma_aerolatum	h_e,
spirosoma_aerolatum	flavobacterium_columnare	
flavobacterium_daejeonense	runella_limosa	h_e,nh4_e,fe2_e,
runella_limosa	flavobacterium_daejeonense	h2o_e,asp__L_e,
flavobacterium_filum	lactobacillus_acidipiscis	
lactobacillus_acidipiscis	flavobacterium_filum	h2o_e,h_e,
flavobacterium_fontis	gramella_forsetii	pi_e,
gramella_forsetii	flavobacterium_fontis	h2s_e,
flavobacterium_hydatis	mangrovimonas_yunxiaonensis	
mangrovimonas_yunxiaonensis	flavobacterium_hydatis	h2o_e,
flavobacterium_indicum	kribbella_catacumbae	no2_e,pi_e,fe3_e,cu2_e,
kribbella_catacumbae	flavobacterium_indicum	h2o_e,
flavobacterium_marinum	pseudopedobacter_saltans	h2o_e,pi_e,
pseudopedobacter_saltans	flavobacterium_marinum	
flavobacterium_noncentrifugens	grimontia_hollisae	
grimontia_hollisae	flavobacterium_noncentrifugens	pi_e,asp__L_e,gua_e,h2s_e,
flavobacterium_sinopsychrotolerans	ornithobacterium_rhinotracheale	
ornithobacterium_rhinotracheale	flavobacterium_sinopsychrotolerans	
flavobacterium_subsaxonicum	treponema_bryantii	
treponema_bryantii	flavobacterium_subsaxonicum	nh4_e,
flavobacterium_suncheonense	sodalis_praecaptivus	thym_e,
sodalis_praecaptivus	flavobacterium_suncheonense	asp__L_e,fe2_e,
flavobacterium_ummariense	gramella_portivictoriae	pi_e,
gramella_portivictoriae	flavobacterium_ummariense	acald_e,h2s_e,fe2_e,
flavobacterium_xueshanense	maribacter_forsetii	
maribacter_forsetii	flavobacterium_xueshanense	acald_e,no2_e,pi_e,
flexilinea_flocculi	nonomuraea_candida	nh4_e,no2_e,fe3_e,cu2_e,
nonomuraea_candida	flexilinea_flocculi	h2o_e,acald_e,pi_e,
flexistipes_sinusarabici	roseivivax_lentus	nh4_e,
roseivivax_lentus	flexistipes_sinusarabici	h_e,ala__L_e,ala__D_e,h2s_e,
flexistipes_sinusarabici	thermodesulfatator_indicus	nh4_e,
thermodesulfatator_indicus	flexistipes_sinusarabici	pi_e,
fluoribacter_dumoffii	streptococcus_varani	ade_e,val__L_e,for_e,
streptococcus_varani	fluoribacter_dumoffii	nh4_e,fe2_e,
fodinicurvata_sediminis	mariprofundus_ferrooxydans	h_e,h2o_e,mal__L_e,
mariprofundus_ferrooxydans	fodinicurvata_sediminis	pi_e,
fontibacillus_panacisegetis	pseudomonas_sabulinigri	h2o_e,nh4_e,h_e,gly_e,
pseudomonas_sabulinigri	fontibacillus_panacisegetis	pi_e,ade_e,
fortiea_contorta	halodesulfovibrio_marinisediminis	pi_e,
halodesulfovibrio_marinisediminis	fortiea_contorta	
francisella_halioticida	moheibacter_sediminis	nh4_e,h2s_e,fe2_e,for_e,
moheibacter_sediminis	francisella_halioticida	pi_e,
frankia_casuarinae	marivirga_tractuosa	h_e,pro__L_e,
marivirga_tractuosa	frankia_casuarinae	h2s_e,
frankia_discariae	gluconacetobacter_diazotrophicus	
gluconacetobacter_diazotrophicus	frankia_discariae	h_e,h2s_e,
frankia_inefficax	lentzea_guizhouensis	
lentzea_guizhouensis	frankia_inefficax	h2s_e,
frankia_symbiont	sinorhizobium_medicae	h_e,
sinorhizobium_medicae	frankia_symbiont	h2o_e,
frateuria_terrea	sphingopyxis_granuli	glu__L_e,nh4_e,h2s_e,fe3_e,cu2_e,
sphingopyxis_granuli	frateuria_terrea	
friedmanniella_luteola	tranquillimonas_alkanivorans	pi_e,cu2_e,
tranquillimonas_alkanivorans	friedmanniella_luteola	h2s_e,
friedmanniella_sagamiharensis	streptomyces_oceani	h2o_e,
streptomyces_oceani	friedmanniella_sagamiharensis	fum_e,
frischella_perrara	legionella_pneumophila	akg_e,pi_e,fe2_e,
legionella_pneumophila	frischella_perrara	glu__L_e,acald_e,nh4_e,
fuerstia_marisgermanicae	lactobacillus_paucivorans	ala__D_e,
lactobacillus_paucivorans	fuerstia_marisgermanicae	h2o_e,gly_e,asp__L_e,cgly_e,pi_e,
fulvivirga_imtechensis	silvibacterium_bohemicum	h2o_e,h_e,pi_e,h2s_e,
silvibacterium_bohemicum	fulvivirga_imtechensis	no2_e,
galbibacter_marinus	owenweeksia_hongkongensis	fe2_e,
owenweeksia_hongkongensis	galbibacter_marinus	pi_e,for_e,
gallaecimonas_xiamenensis	vibrio_campbellii	h2o_e,
vibrio_campbellii	gallaecimonas_xiamenensis	no2_e,fe3_e,cu2_e,
gallionella_capsiferriformans	sphingopyxis_flava	nh4_e,
sphingopyxis_flava	gallionella_capsiferriformans	h_e,fe2_e,
gayadomonas_joobiniege	oblitimonas_alkaliphila	gly_e,fe3_e,cu2_e,
oblitimonas_alkaliphila	gayadomonas_joobiniege	nh4_e,h2s_e,
gemella_asaccharolytica	spirochaeta_cellobiosiphila	nh4_e,fe2_e,
spirochaeta_cellobiosiphila	gemella_asaccharolytica	no2_e,
geminicoccus_roseus	myxococcus_fulvus	h2o_e,nh4_e,
myxococcus_fulvus	geminicoccus_roseus	no2_e,
geminocystis_herdmanii	listeria_floridensis	pro__L_e,
listeria_floridensis	geminocystis_herdmanii	
gemmata_obscuriglobus	leptospira_interrogans	pi_e,
leptospira_interrogans	gemmata_obscuriglobus	for_e,
gemmatimonas_aurantiaca	paenibacillus_darwinianus	h2o_e,
paenibacillus_darwinianus	gemmatimonas_aurantiaca	h_e,asp__L_e,h2s_e,fe3_e,
gemmatimonas_phototrophica	micromonospora_auratinigra	h2s_e,
micromonospora_auratinigra	gemmatimonas_phototrophica	
gemmatimonas_phototrophica	tessaracoccus_flavus	h2o_e,lac__L_e,
tessaracoccus_flavus	gemmatimonas_phototrophica	h_e,
gemmatimonas_phototrophica	williamsia_sterculiae	h2o_e,
williamsia_sterculiae	gemmatimonas_phototrophica	acald_e,
gemmobacter_aquatilis	tropicimonas_isoalkanivorans	glyc_e,cu2_e,
tropicimonas_isoalkanivorans	gemmobacter_aquatilis	fum_e,acald_e,nh4_e,
gemmobacter_megaterium	loktanella_vestfoldensis	h_e,
loktanella_vestfoldensis	gemmobacter_megaterium	nh4_e,
geoalkalibacter_ferrihydriticus	geobacter_pickeringii	
geobacter_pickeringii	geoalkalibacter_ferrihydriticus	glyc_e,
geoalkalibacter_ferrihydriticus	treponema_vincentii	glyclt_e,
treponema_vincentii	geoalkalibacter_ferrihydriticus	h2o_e,h_e,
geobacter_sulfurreducens	oceanithermus_profundus	no2_e,
oceanithermus_profundus	geobacter_sulfurreducens	h2o_e,h_e,
geobacter_uraniireducens	prochlorococcus_marinus	acald_e,glyclt_e,fe2_e,
prochlorococcus_marinus	geobacter_uraniireducens	
geodermatophilus_amargosae	spiribacter_curvatus	h_e,pi_e,
spiribacter_curvatus	geodermatophilus_amargosae	acald_e,
geodermatophilus_obscurus	lysinimicrobium_mangrovi	ala__L_e,h2s_e,
lysinimicrobium_mangrovi	geodermatophilus_obscurus	
geodermatophilus_obscurus	phycicoccus_cremeus	h2o_e,
phycicoccus_cremeus	geodermatophilus_obscurus	
geodermatophilus_obscurus	streptomyces_guanduensis	no2_e,cu2_e,
streptomyces_guanduensis	geodermatophilus_obscurus	orn_e,
geodermatophilus_obscurus	streptomyces_scabiei	ala__L_e,
streptomyces_scabiei	geodermatophilus_obscurus	
geodermatophilus_obscurus	zavarzinella_formosa	h2o_e,pi_e,fe2_e,
zavarzinella_formosa	geodermatophilus_obscurus	glu__L_e,orn_e,
geodermatophilus_pulveris	mycobacterium_smegmatis	
mycobacterium_smegmatis	geodermatophilus_pulveris	h_e,lac__L_e,
geodermatophilus_ruber	pseudooceanicola_nanhaiensis	pi_e,gua_e,
pseudooceanicola_nanhaiensis	geodermatophilus_ruber	h2s_e,
geodermatophilus_saharensis	lactobacillus_hominis	
lactobacillus_hominis	geodermatophilus_saharensis	acald_e,glu__L_e,succ_e,
geodermatophilus_siccatus	mycoplasma_canadense	h_e,h2s_e,
mycoplasma_canadense	geodermatophilus_siccatus	asp__L_e,
geodermatophilus_taihuensis	siccibacter_turicensis	no2_e,
siccibacter_turicensis	geodermatophilus_taihuensis	
gloeomargarita_lithophora	rhodococcus_kunmingensis	nh4_e,
rhodococcus_kunmingensis	gloeomargarita_lithophora	h2s_e,fe2_e,
glycomyces_sambucus	meiothermus_ruber	h_e,h2o_e,pi_e,
meiothermus_ruber	glycomyces_sambucus	nh4_e,fum_e,
gordonia_bronchialis	nocardioides_psychrotolerans	mal__L_e,
nocardioides_psychrotolerans	gordonia_bronchialis	h_e,
gordonia_kroppenstedtii	solirubrum_puertoriconensis	h_e,pro__L_e,xtsn_e,
solirubrum_puertoriconensis	gordonia_kroppenstedtii	pi_e,
gordonia_malaquae	sulfitobacter_noctilucae	h2o_e,
sulfitobacter_noctilucae	gordonia_malaquae	nh4_e,
gordonia_neofelifaecis	idiomarina_indica	
idiomarina_indica	gordonia_neofelifaecis	glu__L_e,val__L_e,
gordonia_shandongensis	propionibacterium_acidifaciens	
propionibacterium_acidifaciens	gordonia_shandongensis	
gorillibacterium_massiliense	lachnospiraceae_bacterium	acald_e,
lachnospiraceae_bacterium	gorillibacterium_massiliense	
gorillibacterium_massiliense	mailhella_massiliensis	
mailhella_massiliensis	gorillibacterium_massiliense	
gorillibacterium_massiliense	paenibacillus_borealis	
paenibacillus_borealis	gorillibacterium_massiliense	
gracilibacillus_boraciitolerans	orrella_dioscoreae	h2o_e,h_e,gly_e,
orrella_dioscoreae	gracilibacillus_boraciitolerans	ser__D_e,h2s_e,
gracilibacillus_kekensis	labrenzia_aggregata	pi_e,no2_e,
labrenzia_aggregata	gracilibacillus_kekensis	etoh_e,
gracilibacillus_orientalis	jeotgalicoccus_halophilus	
jeotgalicoccus_halophilus	gracilibacillus_orientalis	
gracilibacillus_orientalis	lactobacillus_farciminis	pi_e,orn_e,
lactobacillus_farciminis	gracilibacillus_orientalis	h_e,
gracilibacillus_timonensis	lactobacillus_ghanensis	mal__L_e,orn_e,
lactobacillus_ghanensis	gracilibacillus_timonensis	h_e,h2o_e,h2s_e,
gramella_flava	spirosoma_aerolatum	h_e,
spirosoma_aerolatum	gramella_flava	
granulibacter_bethesdensis	lactobacillus_nasuensis	
lactobacillus_nasuensis	granulibacter_bethesdensis	nh4_e,
granulicella_mallensis	pedosphaera_parvula	
pedosphaera_parvula	granulicella_mallensis	pyr_e,
granulicella_pectinivorans	ketogulonicigenium_vulgare	h2o_e,
ketogulonicigenium_vulgare	granulicella_pectinivorans	asp__L_e,nh4_e,
granulicella_pectinivorans	propionibacterium_freudenreichii	glu__L_e,no2_e,
propionibacterium_freudenreichii	granulicella_pectinivorans	fum_e,nh4_e,asp__L_e,ade_e,
grimontia_hollisae	pseudomonas_fulva	pi_e,
pseudomonas_fulva	grimontia_hollisae	
haematomicrobium_sanguinis	pseudooceanicola_nanhaiensis	pi_e,gua_e,hxan_e,
pseudooceanicola_nanhaiensis	haematomicrobium_sanguinis	h2o_e,no2_e,
haemophilus_paracuniculus	shewanella_amazonensis	
shewanella_amazonensis	haemophilus_paracuniculus	
haemophilus_paracuniculus	streptococcus_gallolyticus	val__L_e,
streptococcus_gallolyticus	haemophilus_paracuniculus	nh4_e,ura_e,ade_e,
halalkalibacillus_halophilus	vibrio_toranzoniae	gly_e,
vibrio_toranzoniae	halalkalibacillus_halophilus	
halanaerobium_hydrogeniformans	oceanobacillus_rekensis	h2_e,ala__L_e,
oceanobacillus_rekensis	halanaerobium_hydrogeniformans	fe2_e,
halarsenatibacter_silvermanii	reyranella_massiliensis	etoh_e,
reyranella_massiliensis	halarsenatibacter_silvermanii	ura_e,
haliscomenobacter_hydrossis	nakamurella_panacisegetis	acald_e,
nakamurella_panacisegetis	haliscomenobacter_hydrossis	h_e,fe3_e,
halobacteroides_halobius	halotalea_alkalilenta	
halotalea_alkalilenta	halobacteroides_halobius	asp__L_e,ile__L_e,h2s_e,
halocynthiibacter_namhaensis	rhizobium_oryzae	h2o_e,nh4_e,
rhizobium_oryzae	halocynthiibacter_namhaensis	h2s_e,
haloglycomyces_albus	schleiferia_thermophila	h_e,pi_e,h2s_e,
schleiferia_thermophila	haloglycomyces_albus	
halolactibacillus_alkaliphilus	sphingopyxis_indica	asp__L_e,
sphingopyxis_indica	halolactibacillus_alkaliphilus	
halomonas_aestuarii	novispirillum_itersonii	
novispirillum_itersonii	halomonas_aestuarii	nh4_e,ura_e,
halomonas_chromatireducens	microbulbifer_yueqingensis	
microbulbifer_yueqingensis	halomonas_chromatireducens	
halomonas_daqiaonensis	lactobacillus_crustorum	pi_e,nh4_e,
lactobacillus_crustorum	halomonas_daqiaonensis	acald_e,ala__L_e,ura_e,ala__D_e,
halomonas_ilicicola	methylocystis_bryophila	glu__L_e,pi_e,fe2_e,
methylocystis_bryophila	halomonas_ilicicola	
halomonas_smyrnensis	pontibacter_korlensis	h2s_e,bz_e,
pontibacter_korlensis	halomonas_smyrnensis	
halomonas_subglaciescola	rhodomicrobium_vannielii	pi_e,
rhodomicrobium_vannielii	halomonas_subglaciescola	acald_e,no2_e,
halomonas_zincidurans	oceanicoccus_sagamiensis	h2o_e,cu2_e,
oceanicoccus_sagamiensis	halomonas_zincidurans	for_e,
haloplasma_contractile	thermithiobacillus_tepidarius	h_e,glyc_e,leu__L_e,acald_e,pi_e,
thermithiobacillus_tepidarius	haloplasma_contractile	nh4_e,phe__L_e,
halorhodospira_halophila	herminiimonas_arsenicoxydans	nh4_e,
herminiimonas_arsenicoxydans	halorhodospira_halophila	
halothermothrix_orenii	herbaspirillum_seropedicae	
herbaspirillum_seropedicae	halothermothrix_orenii	mal__L_e,
halothiobacillus_neapolitanus	streptomyces_oceani	
streptomyces_oceani	halothiobacillus_neapolitanus	
helicobacter_bilis	spiroplasma_turonicum	h_e,h2s_e,
spiroplasma_turonicum	helicobacter_bilis	for_e,
helicobacter_felis	nitrospira_japonica	no2_e,val__L_e,hxan_e,fe2_e,
nitrospira_japonica	helicobacter_felis	
helicobacter_jaachi	pedobacter_oryzae	pi_e,
pedobacter_oryzae	helicobacter_jaachi	h2s_e,
helicobacter_macacae	nitrosospira_multiformis	asp__L_e,
nitrosospira_multiformis	helicobacter_macacae	pi_e,h2s_e,
helicobacter_muridarum	mycobacterium_shinjukuense	lac__L_e,
mycobacterium_shinjukuense	helicobacter_muridarum	h2o_e,pi_e,
helicobacter_muridarum	nonlabens_sediminis	asp__L_e,gly_e,glyclt_e,
nonlabens_sediminis	helicobacter_muridarum	h_e,alltn_e,gua_e,
heliobacterium_modesticaldum	peptoniphilus_urinimassiliensis	acald_e,pi_e,
peptoniphilus_urinimassiliensis	heliobacterium_modesticaldum	h2o_e,
heliobacterium_modesticaldum	proteiniclasticum_ruminis	hxan_e,trp__L_e,
proteiniclasticum_ruminis	heliobacterium_modesticaldum	
heliobacterium_modesticaldum	tistlia_consotensis	pi_e,fe2_e,
tistlia_consotensis	heliobacterium_modesticaldum	h2s_e,
henriciella_litoralis	marinobacter_persicus	nh4_e,no2_e,cu2_e,
marinobacter_persicus	henriciella_litoralis	h2o_e,
herbaspirillum_hiltneri	spirochaeta_cellobiosiphila	pro__L_e,ade_e,fe2_e,
spirochaeta_cellobiosiphila	herbaspirillum_hiltneri	
herbaspirillum_rhizosphaerae	microlunatus_phosphovorus	
microlunatus_phosphovorus	herbaspirillum_rhizosphaerae	
herbaspirillum_seropedicae	herbidospora_sakaeratensis	mal__L_e,
herbidospora_sakaeratensis	herbaspirillum_seropedicae	
herbiconiux_ginsengi	mastigocoleus_testarum	fum_e,
mastigocoleus_testarum	herbiconiux_ginsengi	no2_e,
herbidospora_mongoliensis	methylocapsa_palsarum	4abut_e,
methylocapsa_palsarum	herbidospora_mongoliensis	pro__L_e,
hippea_alviniae	tenacibaculum_holothuriorum	ser__L_e,h2s_e,
tenacibaculum_holothuriorum	hippea_alviniae	h2o_e,fe2_e,
hippea_maritima	roseibacterium_elongatum	
roseibacterium_elongatum	hippea_maritima	
hirschia_maritima	microbacterium_sediminis	pi_e,
microbacterium_sediminis	hirschia_maritima	
hoyosella_subflava	sedimenticola_thiotaurini	nh4_e,pi_e,
sedimenticola_thiotaurini	hoyosella_subflava	acald_e,
hugenholtzia_roseola	ruminococcaceae_bacterium	nh4_e,
ruminococcaceae_bacterium	hugenholtzia_roseola	ala__L_e,gly_e,
hyalangium_minutum	sphaerochaeta_coccoides	h2s_e,
sphaerochaeta_coccoides	hyalangium_minutum	
hydrogenovibrio_crunogenus	rheinheimera_salexigens	gly_e,
rheinheimera_salexigens	hydrogenovibrio_crunogenus	pi_e,fe2_e,
hymenobacter_glacialis	planomicrobium_glaciei	val__L_e,thym_e,
planomicrobium_glaciei	hymenobacter_glacialis	nh4_e,
hymenobacter_glacialis	thermovibrio_ammonificans	pi_e,
thermovibrio_ammonificans	hymenobacter_glacialis	nh4_e,h_e,
hymenobacter_psychrophilus	rufibacter_ruber	pi_e,
rufibacter_ruber	hymenobacter_psychrophilus	no2_e,asp__L_e,
hymenobacter_swuensis	sphingomonas_laterariae	h2o_e,
sphingomonas_laterariae	hymenobacter_swuensis	acald_e,
hymenobacter_terrenus	lentibacillus_amyloliquefaciens	glu__L_e,
lentibacillus_amyloliquefaciens	hymenobacter_terrenus	
hyphomonas_atlantica	paucisalibacillus_globulus	nh4_e,cu2_e,
paucisalibacillus_globulus	hyphomonas_atlantica	pi_e,h2s_e,
hyphomonas_beringensis	pelobacter_acetylenicus	nh4_e,h2o_e,h2s_e,
pelobacter_acetylenicus	hyphomonas_beringensis	h_e,cu2_e,
hyphomonas_jannaschiana	thioclava_dalianensis	asp__L_e,pi_e,
thioclava_dalianensis	hyphomonas_jannaschiana	h2o_e,
hyunsoonleella_jejuensis	lactobacillus_mucosae	glu__L_e,h_e,acald_e,
lactobacillus_mucosae	hyunsoonleella_jejuensis	h2o_e,pi_e,gly_e,cgly_e,h2s_e,
ideonella_sakaiensis	luteimonas_abyssi	
luteimonas_abyssi	ideonella_sakaiensis	
idiomarina_planktonica	roseivivax_atlanticus	pyr_e,
roseivivax_atlanticus	idiomarina_planktonica	pi_e,h2s_e,
ignavibacterium_album	nitrospira_moscoviensis	pi_e,h2s_e,for_e,
nitrospira_moscoviensis	ignavibacterium_album	glu__L_e,
ilumatobacter_nonamiensis	paraburkholderia_phymatum	
paraburkholderia_phymatum	ilumatobacter_nonamiensis	h2o_e,adn_e,
ilyobacter_polytropus	oxalobacter_formigenes	no2_e,glu__L_e,fe2_e,
oxalobacter_formigenes	ilyobacter_polytropus	
ilyobacter_polytropus	peptoniphilus_timonensis	ade_e,
peptoniphilus_timonensis	ilyobacter_polytropus	ala__L_e,for_e,
imtechella_halotolerans	lutibacter_agarilyticus	h_e,nh4_e,
lutibacter_agarilyticus	imtechella_halotolerans	
intrasporangium_oryzae	sphingopyxis_alaskensis	
sphingopyxis_alaskensis	intrasporangium_oryzae	h_e,
isosphaera_pallida	myroides_phaeus	
myroides_phaeus	isosphaera_pallida	pi_e,asp__L_e,fe2_e,
jannaschia_aquimarina	pacificimonas_flava	
pacificimonas_flava	jannaschia_aquimarina	
jannaschia_faecimaris	kiritimatiella_glycovorans	h2o_e,
kiritimatiella_glycovorans	jannaschia_faecimaris	
jannaschia_faecimaris	melioribacter_roseus	nh4_e,for_e,
melioribacter_roseus	jannaschia_faecimaris	h_e,
jannaschia_faecimaris	pseudodesulfovibrio_aespoeensis	nh4_e,
pseudodesulfovibrio_aespoeensis	jannaschia_faecimaris	
jannaschia_faecimaris	streptomyces_griseochromogenes	h2o_e,nh4_e,
streptomyces_griseochromogenes	jannaschia_faecimaris	
jatrophihabitans_endophyticus	lactobacillus_helveticus	mal__L_e,acald_e,
lactobacillus_helveticus	jatrophihabitans_endophyticus	h2s_e,
jeotgalibacillus_malaysiensis	nodosilinea_nodulosa	gly_e,
nodosilinea_nodulosa	jeotgalibacillus_malaysiensis	nh4_e,pi_e,
jiangella_muralis	streptomyces_pristinaespiralis	cgly_e,h_e,fe3_e,cu2_e,
streptomyces_pristinaespiralis	jiangella_muralis	acald_e,gthrd_e,
joostella_marina	sphingobium_phenoxybenzoativorans	glu__L_e,no2_e,fe3_e,cu2_e,
sphingobium_phenoxybenzoativorans	joostella_marina	nh4_e,
kibdelosporangium_phytohabitans	saccharothrix_espanaensis	h2o_e,
saccharothrix_espanaensis	kibdelosporangium_phytohabitans	
kocuria_rhizophila	nigerium_massiliense	
nigerium_massiliense	kocuria_rhizophila	
komagataeibacter_hansenii	lascolabacillus_massiliensis	fe2_e,
lascolabacillus_massiliensis	komagataeibacter_hansenii	
kordia_zhangzhouensis	lactobacillus_heilongjiangensis	pi_e,
lactobacillus_heilongjiangensis	kordia_zhangzhouensis	asp__L_e,hxan_e,
kordiimonas_lacus	spiroplasma_culicicola	
spiroplasma_culicicola	kordiimonas_lacus	val__L_e,
kosmotoga_arenicorallina	marinospirillum_celere	h_e,val__L_e,h2s_e,
marinospirillum_celere	kosmotoga_arenicorallina	acald_e,fum_e,pi_e,
kozakia_baliensis	roseicitreum_antarcticum	h2o_e,h2s_e,
roseicitreum_antarcticum	kozakia_baliensis	pi_e,
kozakia_baliensis	timonella_senegalensis	h2o_e,no2_e,thym_e,
timonella_senegalensis	kozakia_baliensis	pi_e,
ktedonobacter_racemifer	rhodobacter_sphaeroides	pi_e,
rhodobacter_sphaeroides	ktedonobacter_racemifer	
kurthia_senegalensis	streptobacillus_hongkongensis	
streptobacillus_hongkongensis	kurthia_senegalensis	trp__L_e,succ_e,
kushneria_aurantia	thalassobius_mediterraneus	fe3_e,
thalassobius_mediterraneus	kushneria_aurantia	h2o_e,h2s_e,
kushneria_marisflavi	nocardia_terpenica	
nocardia_terpenica	kushneria_marisflavi	
kushneria_marisflavi	saccharomonospora_glauca	
saccharomonospora_glauca	kushneria_marisflavi	pi_e,
kutzneria_albida	oleispira_antarctica	
oleispira_antarctica	kutzneria_albida	acald_e,
labilibacter_aurantiacus	parabacteroides_chartae	h_e,pi_e,
parabacteroides_chartae	labilibacter_aurantiacus	
labilibacter_aurantiacus	porphyromonas_crevioricanis	h_e,glu__L_e,gua_e,
porphyromonas_crevioricanis	labilibacter_aurantiacus	h2o_e,
labrenzia_aggregata	marinilabilia_salmonicolor	glu__L_e,orn_e,
marinilabilia_salmonicolor	labrenzia_aggregata	h_e,gthrd_e,pi_e,pro__L_e,
labrenzia_alexandrii	pseudomonas_citronellolis	
pseudomonas_citronellolis	labrenzia_alexandrii	h_e,
labrenzia_suaedae	rhizobium_selenitireducens	nh4_e,
rhizobium_selenitireducens	labrenzia_suaedae	no2_e,
lachnospiraceae_bacterium	lachnospiraceae_bacterium	
lachnospiraceae_bacterium	lachnospiraceae_bacterium	
lachnospiraceae_bacterium	planococcus_maritimus	nh4_e,gly_e,pro__L_e,
planococcus_maritimus	lachnospiraceae_bacterium	asp__L_e,
lachnospiraceae_bacterium	tannerella_forsythia	nh4_e,ade_e,
tannerella_forsythia	lachnospiraceae_bacterium	
lachnospiraceae_bacterium	thermoactinomyces_daqus	h2o_e,ser__L_e,
thermoactinomyces_daqus	lachnospiraceae_bacterium	asp__L_e,
lachnospiraceae_bacterium	syntrophomonas_zehnderi	nh4_e,h2o_e,
syntrophomonas_zehnderi	lachnospiraceae_bacterium	
lachnospiraceae_bacterium	prevotella_bryantii	nh4_e,gua_e,
prevotella_bryantii	lachnospiraceae_bacterium	h_e,ala__L_e,
lachnospiraceae_bacterium	natronincola_ferrireducens	nh4_e,gly_e,val__L_e,pro__L_e,
natronincola_ferrireducens	lachnospiraceae_bacterium	ura_e,
lachnospiraceae_bacterium	natronincola_peptidivorans	nh4_e,fum_e,
natronincola_peptidivorans	lachnospiraceae_bacterium	h_e,
lachnospiraceae_bacterium	lachnospiraceae_bacterium	
lachnospiraceae_bacterium	lachnospiraceae_bacterium	
lachnospiraceae_bacterium	lachnospiraceae_bacterium	
lachnospiraceae_bacterium	lachnospiraceae_bacterium	
lachnospiraceae_bacterium	lachnospiraceae_bacterium	
lachnospiraceae_bacterium	lachnospiraceae_bacterium	
lachnospiraceae_bacterium	levyella_massiliensis	nh4_e,pro__L_e,
levyella_massiliensis	lachnospiraceae_bacterium	h_e,
lachnospiraceae_bacterium	mucilaginibacter_mallensis	nh4_e,h2o_e,
mucilaginibacter_mallensis	lachnospiraceae_bacterium	for_e,
lachnospiraceae_bacterium	pelosinus_fermentans	nh4_e,
pelosinus_fermentans	lachnospiraceae_bacterium	asp__L_e,h_e,
lachnospiraceae_bacterium	symbiobacterium_thermophilum	nh4_e,fum_e,
symbiobacterium_thermophilum	lachnospiraceae_bacterium	glyclt_e,
lacinutrix_himadriensis	thermanaeromonas_toyohensis	
thermanaeromonas_toyohensis	lacinutrix_himadriensis	glyclt_e,
lacinutrix_mariniflava	thermovirga_lienii	h2o_e,asp__L_e,
thermovirga_lienii	lacinutrix_mariniflava	ala__L_e,gly_e,
lacinutrix_venerupis	lactobacillus_senioris	nh4_e,acald_e,cytd_e,
lactobacillus_senioris	lacinutrix_venerupis	gly_e,
lactobacillus_amylovorus	serinicoccus_chungangensis	pro__L_e,
serinicoccus_chungangensis	lactobacillus_amylovorus	
lactobacillus_apinorum	lactobacillus_capillatus	h2o_e,
lactobacillus_capillatus	lactobacillus_apinorum	acald_e,nh4_e,ser__L_e,gua_e,
lactobacillus_apinorum	sediminibacterium_salmoneum	orn_e,cgly_e,fe2_e,bz_e,
sediminibacterium_salmoneum	lactobacillus_apinorum	pi_e,
lactobacillus_buchneri	lactobacillus_silagei	acald_e,
lactobacillus_silagei	lactobacillus_buchneri	ala__L_e,
lactobacillus_camelliae	runella_slithyformis	val__L_e,
runella_slithyformis	lactobacillus_camelliae	
lactobacillus_delbrueckii	teredinibacter_turnerae	gly_e,cgly_e,
teredinibacter_turnerae	lactobacillus_delbrueckii	
lactobacillus_equicursoris	rhodopirellula_islandica	hxan_e,
rhodopirellula_islandica	lactobacillus_equicursoris	so3_e,
lactobacillus_equicursoris	sulfuricella_denitrificans	ala__L_e,gly_e,ala__D_e,
sulfuricella_denitrificans	lactobacillus_equicursoris	nh4_e,
lactobacillus_floricola	pontibaca_methylaminivorans	
pontibaca_methylaminivorans	lactobacillus_floricola	ser__L_e,
lactobacillus_ginsenosidimutans	thermovenabulum_gondwanense	nh4_e,
thermovenabulum_gondwanense	lactobacillus_ginsenosidimutans	pi_e,
lactobacillus_hokkaidonensis	saprospira_grandis	h2o_e,
saprospira_grandis	lactobacillus_hokkaidonensis	h_e,glu__L_e,
lactobacillus_hordei	staphylococcus_pettenkoferi	
staphylococcus_pettenkoferi	lactobacillus_hordei	pi_e,
lactobacillus_iners	methylovulum_miyakonense	h2o_e,h2s_e,
methylovulum_miyakonense	lactobacillus_iners	mal__L_e,pi_e,
lactobacillus_koreensis	microvirga_massiliensis	nh4_e,
microvirga_massiliensis	lactobacillus_koreensis	h2o_e,h_e,
lactobacillus_koreensis	nocardiopsis_sinuspersici	gly_e,nh4_e,
nocardiopsis_sinuspersici	lactobacillus_koreensis	pi_e,
lactobacillus_kullabergensis	mycobacterium_simiae	
mycobacterium_simiae	lactobacillus_kullabergensis	h_e,ala__D_e,
lactobacillus_kunkeei	pseudomonas_resinovorans	ala__L_e,asp__L_e,
pseudomonas_resinovorans	lactobacillus_kunkeei	h2o_e,h_e,
lactobacillus_kunkeei	simiduia_agarivorans	ala__L_e,asp__L_e,gly_e,
simiduia_agarivorans	lactobacillus_kunkeei	fe2_e,
lactobacillus_lindneri	petrimonas_mucosa	acald_e,glu__L_e,
petrimonas_mucosa	lactobacillus_lindneri	h_e,pi_e,h2o_e,h2s_e,
lactobacillus_mellifer	legionella_steelei	gly_e,tyr__L_e,cu2_e,
legionella_steelei	lactobacillus_mellifer	akg_e,ser__L_e,
lactobacillus_nodensis	oceanicola_litoreus	h2o_e,gly_e,fe3_e,
oceanicola_litoreus	lactobacillus_nodensis	nh4_e,h2s_e,
lactobacillus_ozensis	paraglaciecola_arctica	
paraglaciecola_arctica	lactobacillus_ozensis	
lactobacillus_parabrevis	leptospira_alstonii	h2o_e,asp__L_e,cgly_e,fe2_e,
leptospira_alstonii	lactobacillus_parabrevis	
lactobacillus_parabuchneri	sporosarcina_koreensis	nh4_e,asp__L_e,ala__D_e,cgly_e,
sporosarcina_koreensis	lactobacillus_parabuchneri	
lactobacillus_secaliphilus	sporosarcina_newyorkensis	asp__L_e,
sporosarcina_newyorkensis	lactobacillus_secaliphilus	nh4_e,
lactobacillus_secaliphilus	xanthomonas_oryzae	val__L_e,
xanthomonas_oryzae	lactobacillus_secaliphilus	
lactobacillus_shenzhenensis	streptomyces_aidingensis	
streptomyces_aidingensis	lactobacillus_shenzhenensis	pi_e,h2s_e,ade_e,
lactobacillus_similis	porphyrobacter_dokdonensis	
porphyrobacter_dokdonensis	lactobacillus_similis	
lactobacillus_xiangfangensis	sulfurimonas_denitrificans	val__L_e,
sulfurimonas_denitrificans	lactobacillus_xiangfangensis	
lactobacillus_zymae	nocardia_jejuensis	h2o_e,asp__L_e,
nocardia_jejuensis	lactobacillus_zymae	urea_e,fum_e,
lactococcus_piscium	polaromonas_naphthalenivorans	nh4_e,
polaromonas_naphthalenivorans	lactococcus_piscium	
lagierella_massiliensis	sebaldella_termitidis	h2o_e,ala__L_e,h2s_e,succ_e,
sebaldella_termitidis	lagierella_massiliensis	acald_e,fe2_e,
lascolabacillus_massiliensis	mycoplasma_dispar	
mycoplasma_dispar	lascolabacillus_massiliensis	h2o_e,asp__L_e,fe2_e,
legionella_massiliensis	ruegeria_conchae	fe3_e,
ruegeria_conchae	legionella_massiliensis	h2o_e,
legionella_norrlandica	wohlfahrtiimonas_larvae	pi_e,fe3_e,for_e,
wohlfahrtiimonas_larvae	legionella_norrlandica	alltn_e,
legionella_oakridgensis	muricauda_ruestringensis	
muricauda_ruestringensis	legionella_oakridgensis	glu__L_e,h2o_e,h_e,pi_e,val__L_e,no2_e,
leisingera_methylohalidivorans	saccharomonospora_saliphila	
saccharomonospora_saliphila	leisingera_methylohalidivorans	pi_e,
lentibacillus_amyloliquefaciens	streptomyces_niveus	
streptomyces_niveus	lentibacillus_amyloliquefaciens	acald_e,fum_e,
lentibacillus_persicus	mobilicoccus_pelagius	acald_e,
mobilicoccus_pelagius	lentibacillus_persicus	h2s_e,h_e,
lentibacter_algarum	thermanaerovibrio_velox	nh4_e,orn_e,
thermanaerovibrio_velox	lentibacter_algarum	h2o_e,
lentimicrobium_saccharophilum	magnetococcus_marinus	pi_e,
magnetococcus_marinus	lentimicrobium_saccharophilum	acald_e,
leptolyngbya_valderiana	sinomonas_atrocyanea	nh4_e,gly_e,
sinomonas_atrocyanea	leptolyngbya_valderiana	h2o_e,pi_e,mal__L_e,
leptospirillum_ferrooxidans	lutibacter_maritimus	
lutibacter_maritimus	leptospirillum_ferrooxidans	h2o_e,pyr_e,pi_e,fe2_e,
leptothrix_cholodnii	streptomyces_lydicus	acald_e,xan_e,
streptomyces_lydicus	leptothrix_cholodnii	pi_e,
leptotrichia_goodfellowii	mycoplasma_arginini	h2o_e,acald_e,
mycoplasma_arginini	leptotrichia_goodfellowii	h_e,trp__L_e,
leucobacter_salsicius	pimelobacter_simplex	glu__L_e,h2s_e,
pimelobacter_simplex	leucobacter_salsicius	for_e,
limimonas_halophila	pediococcus_argentinicus	glyc_e,
pediococcus_argentinicus	limimonas_halophila	
limimonas_halophila	pedobacter_heparinus	glyc_e,
pedobacter_heparinus	limimonas_halophila	fe2_e,cu2_e,for_e,
limnochorda_pilosa	peptoniphilus_duerdenii	h2o_e,fe2_e,
peptoniphilus_duerdenii	limnochorda_pilosa	h_e,mal__L_e,ura_e,
litoreibacter_albidus	parapedobacter_koreensis	glyc_e,nh4_e,for_e,
parapedobacter_koreensis	litoreibacter_albidus	pi_e,cytd_e,
litoreibacter_arenae	methylobacterium_radiotolerans	lac__D_e,etoh_e,
methylobacterium_radiotolerans	litoreibacter_arenae	
litoreibacter_arenae	mycoplasma_mobile	h2o_e,
mycoplasma_mobile	litoreibacter_arenae	h2s_e,succ_e,
litoreibacter_ascidiaceicola	tessaracoccus_flavescens	
tessaracoccus_flavescens	litoreibacter_ascidiaceicola	ala__L_e,
litorimicrobium_taeanense	sulfuritalea_hydrogenivorans	
sulfuritalea_hydrogenivorans	litorimicrobium_taeanense	h2o_e,
loktanella_litorea	nitrosomonas_marina	
nitrosomonas_marina	loktanella_litorea	pyr_e,cu2_e,
loktanella_litorea	scytonema_hofmanni	
scytonema_hofmanni	loktanella_litorea	
loktanella_pyoseonensis	pseudooceanicola_nitratireducens	
pseudooceanicola_nitratireducens	loktanella_pyoseonensis	
loktanella_sediminum	richelia_intracellularis	fum_e,
richelia_intracellularis	loktanella_sediminum	fe2_e,
loktanella_tamlensis	pediococcus_stilesii	
pediococcus_stilesii	loktanella_tamlensis	val__L_e,
loktanella_vestfoldensis	marinobacter_nanhaiticus	nh4_e,ala__L_e,
marinobacter_nanhaiticus	loktanella_vestfoldensis	pi_e,
loktanella_vestfoldensis	tuberibacillus_calidus	ala__D_e,nh4_e,ala__L_e,
tuberibacillus_calidus	loktanella_vestfoldensis	glyc_e,fe3_e,
longilinea_arvoryzae	proteiniphilum_saccharofermentans	fe2_e,
proteiniphilum_saccharofermentans	longilinea_arvoryzae	pi_e,glu__L_e,
lunatimonas_lonarensis	niastella_populi	h2o_e,
niastella_populi	lunatimonas_lonarensis	pi_e,no2_e,
luteibacter_yeojuensis	salinispora_arenicola	asp__L_e,nh4_e,h2s_e,
salinispora_arenicola	luteibacter_yeojuensis	gthrd_e,
luteibacter_yeojuensis	steroidobacter_denitrificans	pro__L_e,
steroidobacter_denitrificans	luteibacter_yeojuensis	
luteimonas_abyssi	rhizobacter_gummiphilus	
rhizobacter_gummiphilus	luteimonas_abyssi	
luteimonas_huabeiensis	polaromonas_jejuensis	
polaromonas_jejuensis	luteimonas_huabeiensis	
lutibacter_flavus	paraburkholderia_rhizoxinica	h2o_e,
paraburkholderia_rhizoxinica	lutibacter_flavus	acald_e,ade_e,
lutibacter_maritimus	streptomyces_davawensis	h2o_e,ala__L_e,
streptomyces_davawensis	lutibacter_maritimus	acald_e,
lutibaculum_baratangense	xiangella_phaseoli	h2o_e,glyc_e,h2s_e,
xiangella_phaseoli	lutibaculum_baratangense	cgly_e,
lutimaribacter_saemankumensis	wenyingzhuangia_marina	h_e,
wenyingzhuangia_marina	lutimaribacter_saemankumensis	h2s_e,
lysinibacillus_sinduriensis	orenia_metallireducens	
orenia_metallireducens	lysinibacillus_sinduriensis	h2o_e,h_e,ala__L_e,
lysinimicrobium_subtropicum	pseudanabaena_biceps	fum_e,nh4_e,h_e,
pseudanabaena_biceps	lysinimicrobium_subtropicum	
lysobacter_dokdonensis	xanthomonas_translucens	
xanthomonas_translucens	lysobacter_dokdonensis	pi_e,
macrococcus_canis	thermosipho_melanesiensis	h2o_e,
thermosipho_melanesiensis	macrococcus_canis	
magnetospirillum_caucaseum	marininema_mesophilum	h2o_e,
marininema_mesophilum	magnetospirillum_caucaseum	glyclt_e,
magnetospirillum_caucaseum	shimia_marina	h2o_e,fe3_e,cu2_e,
shimia_marina	magnetospirillum_caucaseum	fe2_e,nh4_e,
magnetospirillum_gryphiswaldense	paraburkholderia_xenovorans	glu__L_e,
paraburkholderia_xenovorans	magnetospirillum_gryphiswaldense	h2o_e,
magnetospirillum_marisnigri	pseudoruegeria_aquimaris	
pseudoruegeria_aquimaris	magnetospirillum_marisnigri	
magnetospirillum_moscoviense	sphaerochaeta_coccoides	val__L_e,h2s_e,
sphaerochaeta_coccoides	magnetospirillum_moscoviense	nh4_e,no2_e,
mangrovibacter_phragmitis	mycoplasma_hyopneumoniae	gua_e,
mycoplasma_hyopneumoniae	mangrovibacter_phragmitis	thym_e,
maribacter_thermophilus	roseovarius_albus	no2_e,pi_e,
roseovarius_albus	maribacter_thermophilus	nh4_e,
maribius_pelagius	microbacteriaceae_bacterium	orn_e,
microbacteriaceae_bacterium	maribius_pelagius	pi_e,
marichromatium_purpuratum	unicellular_cyanobacterium	acald_e,acald_e,
unicellular_cyanobacterium	marichromatium_purpuratum	h2o_e,
mariniblastus_fucicola	sphingobium_cloacae	glu__L_e,
sphingobium_cloacae	mariniblastus_fucicola	h2o_e,pi_e,
marininema_halotolerans	parvularcula_bermudensis	h2s_e,
parvularcula_bermudensis	marininema_halotolerans	ade_e,
marinobacter_antarcticus	pedobacter_rhizosphaerae	glyc_e,fe2_e,nh4_e,
pedobacter_rhizosphaerae	marinobacter_antarcticus	fe3_e,no2_e,
marinobacter_daqiaonensis	thermus_aquaticus	ura_e,fe2_e,
thermus_aquaticus	marinobacter_daqiaonensis	nh4_e,fe3_e,
marinobacterium_litorale	micromonospora_narathiwatensis	h2s_e,
micromonospora_narathiwatensis	marinobacterium_litorale	
marinobacter_salarius	rhodococcus_kyotonensis	h2o_e,h_e,acald_e,
rhodococcus_kyotonensis	marinobacter_salarius	pro__L_e,
marinobacter_salinus	phaeobacter_gallaeciensis	fe3_e,pi_e,ala__L_e,
phaeobacter_gallaeciensis	marinobacter_salinus	h2o_e,fe2_e,
marinobacter_segnicrescens	roseovarius_nanhaiticus	gly_e,ura_e,
roseovarius_nanhaiticus	marinobacter_segnicrescens	pi_e,cu2_e,
marinobacter_subterrani	rubrobacter_radiotolerans	ade_e,
rubrobacter_radiotolerans	marinobacter_subterrani	pro__L_e,
marinomonas_fungiae	neptunomonas_phycophila	
neptunomonas_phycophila	marinomonas_fungiae	pi_e,ura_e,
marinomonas_mediterranea	rickettsia_akari	
rickettsia_akari	marinomonas_mediterranea	
maritimibacter_alkaliphilus	thermus_amyloliquefaciens	h_e,
thermus_amyloliquefaciens	maritimibacter_alkaliphilus	
marmoricola_aequoreus	tatumella_saanichensis	
tatumella_saanichensis	marmoricola_aequoreus	glu__L_e,
marmoricola_scoriae	streptomyces_scopuliridis	h2o_e,cu2_e,
streptomyces_scopuliridis	marmoricola_scoriae	acald_e,
martelella_endophytica	trueperella_pyogenes	
trueperella_pyogenes	martelella_endophytica	pi_e,ala__L_e,gua_e,fe3_e,cu2_e,
martelella_mediterranea	mucilaginibacter_lappiensis	h2o_e,h_e,
mucilaginibacter_lappiensis	martelella_mediterranea	pi_e,
martelella_mediterranea	thermocrinis_albus	h2o_e,h_e,h2s_e,
thermocrinis_albus	martelella_mediterranea	pro__L_e,gua_e,
massilia_namucuonensis	nocardioides_lianchengensis	h2o_e,cgly_e,mal__L_e,
nocardioides_lianchengensis	massilia_namucuonensis	pi_e,ade_e,
massilia_niastensis	microbacterium_aurum	acald_e,glu__L_e,
microbacterium_aurum	massilia_niastensis	ade_e,
massilia_putida	tetrasphaera_jenkinsii	h2o_e,
tetrasphaera_jenkinsii	massilia_putida	pyr_e,pi_e,ade_e,
massilibacterium_senegalense	virgibacillus_dakarensis	h_e,gly_e,trp__L_e,
virgibacillus_dakarensis	massilibacterium_senegalense	
megasphaera_massiliensis	solitalea_canadensis	fum_e,asp__L_e,ade_e,cgly_e,
solitalea_canadensis	megasphaera_massiliensis	h_e,pi_e,
megasphaera_paucivorans	oceanobacillus_sojae	
oceanobacillus_sojae	megasphaera_paucivorans	
meiothermus_rufus	skermanella_stibiiresistens	ala__D_e,ala__L_e,
skermanella_stibiiresistens	meiothermus_rufus	fe2_e,
meiothermus_silvanus	ohtaekwangia_koreensis	h2o_e,
ohtaekwangia_koreensis	meiothermus_silvanus	
melghirimyces_thermohalophilus	pseudaminobacter_manganicus	pi_e,
pseudaminobacter_manganicus	melghirimyces_thermohalophilus	nh4_e,glyc_e,h2s_e,
melioribacter_roseus	planctomicrobium_piriforme	h_e,gua_e,
planctomicrobium_piriforme	melioribacter_roseus	
mesoaciditoga_lauensis	treponema_caldarium	
treponema_caldarium	mesoaciditoga_lauensis	fe2_e,succ_e,
mesonia_mobilis	robiginitalea_myxolifaciens	
robiginitalea_myxolifaciens	mesonia_mobilis	nh4_e,pi_e,
mesorhizobium_australicum	methylophaga_thiooxydans	h2o_e,h_e,h2s_e,
methylophaga_thiooxydans	mesorhizobium_australicum	nh4_e,gly_e,
methylobacillus_rhizosphaerae	neisseria_mucosa	
neisseria_mucosa	methylobacillus_rhizosphaerae	pi_e,acald_e,fe2_e,
methylobacterium_gossipiicola	nocardia_mikamii	h2o_e,
nocardia_mikamii	methylobacterium_gossipiicola	fum_e,cu2_e,
methylobacterium_populi	thermus_caliditerrae	fe2_e,
thermus_caliditerrae	methylobacterium_populi	nh4_e,fe3_e,
methyloceanibacter_marginalis	streptomyces_clavuligerus	nh4_e,cu2_e,
streptomyces_clavuligerus	methyloceanibacter_marginalis	4abut_e,pi_e,
methyloceanibacter_methanicus	roseibaca_calidilacus	pi_e,
roseibaca_calidilacus	methyloceanibacter_methanicus	h2o_e,
methyloceanibacter_superfactus	tenacibaculum_holothuriorum	h2s_e,
tenacibaculum_holothuriorum	methyloceanibacter_superfactus	h2o_e,
methylocystis_parvus	sphingomonas_jaspsi	h2o_e,
sphingomonas_jaspsi	methylocystis_parvus	pi_e,h2s_e,
methyloferula_stellata	nioella_sediminis	no2_e,pi_e,
nioella_sediminis	methyloferula_stellata	h2o_e,
methylomonas_denitrificans	niabella_ginsenosidivorans	h2o_e,glu__L_e,
niabella_ginsenosidivorans	methylomonas_denitrificans	no2_e,pi_e,
methylomonas_koyamae	methylovulum_psychrotolerans	nh4_e,h_e,asp__L_e,
methylovulum_psychrotolerans	methylomonas_koyamae	glu__L_e,
methylophaga_frappieri	sulfurimonas_hongkongensis	succ_e,for_e,
sulfurimonas_hongkongensis	methylophaga_frappieri	
methylophaga_lonarensis	plautia_stali	asp__L_e,nh4_e,h2s_e,
plautia_stali	methylophaga_lonarensis	glu__L_e,
methylophilus_methylotrophus	myroides_profundi	h_e,ala__L_e,
myroides_profundi	methylophilus_methylotrophus	pi_e,
methylophilus_methylotrophus	pseudacidovorax_intermedius	h_e,
pseudacidovorax_intermedius	methylophilus_methylotrophus	acald_e,
methylophilus_rhizosphaerae	ornithinibacillus_scapharcae	nh4_e,
ornithinibacillus_scapharcae	methylophilus_rhizosphaerae	leu__L_e,pi_e,
methylotenera_mobilis	roseateles_depolymerans	
roseateles_depolymerans	methylotenera_mobilis	fe2_e,
methyloversatilis_discipulorum	nocardiopsis_flavescens	
nocardiopsis_flavescens	methyloversatilis_discipulorum	nh4_e,pi_e,
methyloversatilis_thermotolerans	rhodobacter_capsulatus	h_e,cu2_e,
rhodobacter_capsulatus	methyloversatilis_thermotolerans	nh4_e,pi_e,
methylovulum_miyakonense	photobacterium_sanctipauli	glu__L_e,pi_e,for_e,
photobacterium_sanctipauli	methylovulum_miyakonense	h2o_e,h2s_e,
microbacterium_chocolatum	natribacillus_halophilus	
natribacillus_halophilus	microbacterium_chocolatum	
microbacterium_chocolatum	sediminimonas_qiaohouensis	
sediminimonas_qiaohouensis	microbacterium_chocolatum	h_e,
microbacterium_foliorum	thiomicrospira_cyclica	glu__L_e,fe2_e,
thiomicrospira_cyclica	microbacterium_foliorum	nh4_e,for_e,
microbacterium_indicum	paracoccus_homiensis	ade_e,
paracoccus_homiensis	microbacterium_indicum	nh4_e,
microbulbifer_donghaiensis	mycobacterium_minnesotense	
mycobacterium_minnesotense	microbulbifer_donghaiensis	h2o_e,
microbulbifer_donghaiensis	thioalkalivibrio_nitratireducens	
thioalkalivibrio_nitratireducens	microbulbifer_donghaiensis	nh4_e,
microbulbifer_marinus	noviherbaspirillum_massiliense	pro__L_e,
noviherbaspirillum_massiliense	microbulbifer_marinus	
microbulbifer_marinus	woeseia_oceani	pyr_e,pi_e,
woeseia_oceani	microbulbifer_marinus	h2o_e,
micromonospora_cremea	sphingomonas_haloaromaticamans	
sphingomonas_haloaromaticamans	micromonospora_cremea	acald_e,
micromonospora_pattaloongensis	streptomyces_indicus	ala__D_e,
streptomyces_indicus	micromonospora_pattaloongensis	glu__L_e,h2o_e,pro__L_e,h2s_e,xtsn_e,
micromonospora_rhizosphaerae	nocardia_speluncae	
nocardia_speluncae	micromonospora_rhizosphaerae	
micromonospora_rifamycinica	streptomyces_himastatinicus	h2o_e,glu__L_e,h_e,
streptomyces_himastatinicus	micromonospora_rifamycinica	
micromonospora_rifamycinica	verrucosispora_sediminis	h2o_e,
verrucosispora_sediminis	micromonospora_rifamycinica	
micromonospora_siamensis	streptomyces_cattleya	pi_e,
streptomyces_cattleya	micromonospora_siamensis	h2s_e,fe3_e,
microscilla_marina	pedobacter_nyackensis	glu__L_e,orn_e,acald_e,pi_e,
pedobacter_nyackensis	microscilla_marina	pro__L_e,
microvirga_guangxiensis	paenirhodobacter_enshiensis	nh4_e,
paenirhodobacter_enshiensis	microvirga_guangxiensis	glyc_e,
microvirga_guangxiensis	roseovarius_indicus	nh4_e,
roseovarius_indicus	microvirga_guangxiensis	glyc_e,cu2_e,
microvirga_lotononidis	streptacidiphilus_rugosus	mal__L_e,no2_e,
streptacidiphilus_rugosus	microvirga_lotononidis	fe3_e,
mobiluncus_curtisii	selenomonas_artemidis	h2o_e,val__L_e,fe2_e,
selenomonas_artemidis	mobiluncus_curtisii	
modestobacter_marinus	salinarimonas_rosea	h2o_e,
salinarimonas_rosea	modestobacter_marinus	nh4_e,fum_e,
monashia_flava	stackebrandtia_nassauensis	h2o_e,
stackebrandtia_nassauensis	monashia_flava	glu__L_e,acald_e,
morganella_psychrotolerans	saccharophagus_degradans	h2o_e,etoh_e,no2_e,pro__L_e,
saccharophagus_degradans	morganella_psychrotolerans	pi_e,
mucilaginibacter_pedocola	thermoanaerobaculum_aquaticum	
thermoanaerobaculum_aquaticum	mucilaginibacter_pedocola	h2o_e,h_e,h2s_e,
mucinivorans_hirudinis	salinicoccus_carnicancri	
salinicoccus_carnicancri	mucinivorans_hirudinis	gly_e,
muricauda_lutaonensis	paracoccus_saliphilus	h_e,pi_e,
paracoccus_saliphilus	muricauda_lutaonensis	nh4_e,no2_e,
mycobacterium_abscessus	thermogemmatispora_onikobensis	gly_e,ser__L_e,
thermogemmatispora_onikobensis	mycobacterium_abscessus	
mycobacterium_europaeum	thermodesulfatator_atlanticus	h2o_e,
thermodesulfatator_atlanticus	mycobacterium_europaeum	orn_e,
mycobacterium_fragae	pedobacter_nyackensis	acald_e,h2s_e,
pedobacter_nyackensis	mycobacterium_fragae	h2o_e,
mycobacterium_gilvum	sphingomonas_hengshuiensis	h_e,h2s_e,
sphingomonas_hengshuiensis	mycobacterium_gilvum	
mycobacterium_haemophilum	thermoanaerobacter_kivui	gly_e,
thermoanaerobacter_kivui	mycobacterium_haemophilum	h_e,h2o_e,
mycobacterium_iranicum	spirochaeta_lutea	h2o_e,
spirochaeta_lutea	mycobacterium_iranicum	acald_e,pro__L_e,
mycobacterium_rhodesiae	sphingobium_czechense	
sphingobium_czechense	mycobacterium_rhodesiae	h_e,orn_e,
mycobacterium_shinjukuense	streptomyces_avermitilis	h2o_e,fe3_e,
streptomyces_avermitilis	mycobacterium_shinjukuense	
mycobacterium_terrae	neokomagataea_thailandica	
neokomagataea_thailandica	mycobacterium_terrae	
mycobacterium_vanbaalenii	vibrio_mexicanus	mal__L_e,
vibrio_mexicanus	mycobacterium_vanbaalenii	h_e,
mycoplasma_agalactiae	ruminococcaceae_bacterium	h_e,fe2_e,
ruminococcaceae_bacterium	mycoplasma_agalactiae	
mycoplasma_bovis	spiroplasma_syrphidicola	acald_e,urea_e,
spiroplasma_syrphidicola	mycoplasma_bovis	h_e,thym_e,
mycoplasma_californicum	streptosporangium_roseum	asp__L_e,
streptosporangium_roseum	mycoplasma_californicum	acald_e,h2s_e,
mycoplasma_capricolum	terriglobus_saanensis	h_e,asp__L_e,fe2_e,but_e,succ_e,
terriglobus_saanensis	mycoplasma_capricolum	orn_e,
mycoplasma_cynos	nostoc_piscinale	h_e,
nostoc_piscinale	mycoplasma_cynos	pi_e,
mycoplasma_hominis	sphingomonas_rubra	h2o_e,h_e,succ_e,
sphingomonas_rubra	mycoplasma_hominis	pi_e,orn_e,
mycoplasma_penetrans	thorsellia_anophelis	ala__L_e,for_e,
thorsellia_anophelis	mycoplasma_penetrans	chol_e,trp__L_e,
mycoplasma_pulmonis	nitrosomonas_communis	
nitrosomonas_communis	mycoplasma_pulmonis	nh4_e,
mycoplasma_synoviae	streptomyces_zinciresistens	no2_e,h_e,cu2_e,mal__L_e,
streptomyces_zinciresistens	mycoplasma_synoviae	acald_e,h2s_e,
mycoplasma_yeatsii	weeksella_virosa	ala__L_e,h2s_e,
weeksella_virosa	mycoplasma_yeatsii	glu__L_e,pi_e,
myroides_guanonis	paracoccus_saliphilus	pi_e,
paracoccus_saliphilus	myroides_guanonis	nh4_e,fum_e,
myroides_injenensis	ornithobacterium_rhinotracheale	h2s_e,
ornithobacterium_rhinotracheale	myroides_injenensis	
myxococcus_fulvus	sphaerobacter_thermophilus	
sphaerobacter_thermophilus	myxococcus_fulvus	pi_e,
nakamurella_lactea	oceanibaculum_pacificum	h2o_e,mal__L_e,pi_e,fe2_e,
oceanibaculum_pacificum	nakamurella_lactea	no2_e,acald_e,
nakamurella_multipartita	rathayibacter_tritici	acald_e,
rathayibacter_tritici	nakamurella_multipartita	h2o_e,cu2_e,
natranaerobius_trueperi	pseudoxanthomonas_dokdonensis	h2o_e,
pseudoxanthomonas_dokdonensis	natranaerobius_trueperi	acald_e,fe2_e,
neiella_marina	neisseria_zoodegmatis	
neisseria_zoodegmatis	neiella_marina	pi_e,ala__L_e,
neiella_marina	orientia_chuto	
orientia_chuto	neiella_marina	h_e,icit_e,asp__L_e,
neisseria_mucosa	porticoccus_hydrocarbonoclasticus	asp__L_e,pi_e,
porticoccus_hydrocarbonoclasticus	neisseria_mucosa	glyc_e,gly_e,
neisseria_mucosa	yersinia_enterocolitica	pi_e,ade_e,
yersinia_enterocolitica	neisseria_mucosa	
neomicrococcus_aestuarii	tamlana_agarivorans	pi_e,
tamlana_agarivorans	neomicrococcus_aestuarii	h_e,
neorhizobium_galegae	sporolactobacillus_vineae	
sporolactobacillus_vineae	neorhizobium_galegae	
neptunomonas_qingdaonensis	xanthomonas_massiliensis	h2s_e,
xanthomonas_massiliensis	neptunomonas_qingdaonensis	nh4_e,asp__L_e,fe3_e,
nesterenkonia_massiliensis	salisaeta_longa	h2o_e,pyr_e,h2s_e,
salisaeta_longa	nesterenkonia_massiliensis	pi_e,
niastella_yeongjuensis	salegentibacter_echinorum	glu__L_e,pi_e,
salegentibacter_echinorum	niastella_yeongjuensis	
nitratifractor_salsuginis	pelobacter_propionicus	
pelobacter_propionicus	nitratifractor_salsuginis	pi_e,
nitratifractor_salsuginis	singulisphaera_acidiphila	nh4_e,orn_e,
singulisphaera_acidiphila	nitratifractor_salsuginis	pi_e,
nitratireductor_basaltis	prevotella_ruminicola	h2s_e,
prevotella_ruminicola	nitratireductor_basaltis	h2o_e,
nitratireductor_basaltis	treponema_brennaborense	ile__L_e,fe2_e,
treponema_brennaborense	nitratireductor_basaltis	h2o_e,
nitratireductor_basaltis	treponema_succinifaciens	
treponema_succinifaciens	nitratireductor_basaltis	
nitratireductor_basaltis	xanthomarina_gelatinilytica	
xanthomarina_gelatinilytica	nitratireductor_basaltis	
nitritalea_halalkaliphila	sinomicrobium_oceani	nh4_e,urate_e,fum_e,
sinomicrobium_oceani	nitritalea_halalkaliphila	h_e,h2o_e,
nitrosococcus_halophilus	scardovia_inopinata	pi_e,
scardovia_inopinata	nitrosococcus_halophilus	h2o_e,h2s_e,
nitrosococcus_watsonii	tomitella_biformata	nh4_e,
tomitella_biformata	nitrosococcus_watsonii	
nitrosomonas_eutropha	streptomyces_hokutonensis	
streptomyces_hokutonensis	nitrosomonas_eutropha	acald_e,h2s_e,
nitrosovibrio_tenuis	oceanobacillus_jeddahense	nh4_e,fe3_e,
oceanobacillus_jeddahense	nitrosovibrio_tenuis	acald_e,
nitrospira_defluvii	nocardiopsis_flavescens	
nocardiopsis_flavescens	nitrospira_defluvii	nh4_e,h2s_e,
nitrospira_japonica	shewanella_benthica	h2o_e,h2o2_e,
shewanella_benthica	nitrospira_japonica	no2_e,pi_e,h2s_e,gthox_e,fe2_e,
nitrospirillum_amazonense	vibrio_metschnikovii	h_e,ade_e,
vibrio_metschnikovii	nitrospirillum_amazonense	
nocardia_amikacinitolerans	streptomyces_albireticuli	
streptomyces_albireticuli	nocardia_amikacinitolerans	
nocardia_arizonensis	nocardiopsis_potens	h2o_e,
nocardiopsis_potens	nocardia_arizonensis	pi_e,
nocardia_donostiensis	pseudooceanicola_nitratireducens	
pseudooceanicola_nitratireducens	nocardia_donostiensis	h2o_e,h2s_e,
nocardia_harenae	nocardioides_terrae	
nocardioides_terrae	nocardia_harenae	h2o_e,
nocardia_seriolae	sphingobium_herbicidovorans	fum_e,
sphingobium_herbicidovorans	nocardia_seriolae	
nocardia_seriolae	thermosipho_africanus	
thermosipho_africanus	nocardia_seriolae	h_e,
nocardia_speluncae	pseudoruegeria_lutimaris	gly_e,cu2_e,
pseudoruegeria_lutimaris	nocardia_speluncae	ala__L_e,
nocardioides_insulae	novosphingobium_nitrogenifigens	
novosphingobium_nitrogenifigens	nocardioides_insulae	no2_e,pi_e,
nocardioides_psychrotolerans	stappia_indica	h_e,pi_e,fe3_e,
stappia_indica	nocardioides_psychrotolerans	nh4_e,acald_e,
nocardioides_terrae	vibrio_anguillarum	ura_e,
vibrio_anguillarum	nocardioides_terrae	trp__L_e,
nonlabens_spongiae	nostocales_cyanobacterium	
nostocales_cyanobacterium	nonlabens_spongiae	
nonlabens_spongiae	thermodesulfovibrio_yellowstonii	val__L_e,
thermodesulfovibrio_yellowstonii	nonlabens_spongiae	
nonomuraea_coxensis	thermus_thermophilus	
thermus_thermophilus	nonomuraea_coxensis	nh4_e,
nonomuraea_jiangxiensis	rhodovulum_sulfidophilum	h2o_e,pi_e,
rhodovulum_sulfidophilum	nonomuraea_jiangxiensis	nh4_e,
noviherbaspirillum_autotrophicum	paenibacillus_naphthalenovorans	pi_e,glyclt_e,h2s_e,
paenibacillus_naphthalenovorans	noviherbaspirillum_autotrophicum	akg_e,
novosphingobium_fuchskuhlense	rubrivivax_gelatinosus	
rubrivivax_gelatinosus	novosphingobium_fuchskuhlense	asp__L_e,
novosphingobium_lindaniclasticum	streptomyces_lydicus	acald_e,
streptomyces_lydicus	novosphingobium_lindaniclasticum	
novosphingobium_pentaromativorans	porphyrobacter_neustonensis	
porphyrobacter_neustonensis	novosphingobium_pentaromativorans	
oceanibacterium_hippocampi	roseomonas_cervicalis	
roseomonas_cervicalis	oceanibacterium_hippocampi	asp__L_e,fe3_e,cu2_e,
oceanobacillus_iheyensis	phaeodactylibacter_xiamenensis	pi_e,fe2_e,
phaeodactylibacter_xiamenensis	oceanobacillus_iheyensis	h2s_e,
oceanobacillus_iheyensis	rudanella_lutea	
rudanella_lutea	oceanobacillus_iheyensis	h2s_e,
oceanobacillus_massiliensis	saccharibacillus_kuerlensis	pi_e,
saccharibacillus_kuerlensis	oceanobacillus_massiliensis	
ochrobactrum_anthropi	staphylococcus_lugdunensis	nh4_e,pi_e,
staphylococcus_lugdunensis	ochrobactrum_anthropi	gly_e,fe3_e,
ochrobactrum_pseudogrignonense	saccharomonospora_azurea	
saccharomonospora_azurea	ochrobactrum_pseudogrignonense	
oenococcus_kitaharae	sulfitobacter_pseudonitzschiae	ala__L_e,
sulfitobacter_pseudonitzschiae	oenococcus_kitaharae	h_e,
olsenella_umbonata	phoenicibacter_massiliensis	ade_e,udcpdp_e,acald_e,
phoenicibacter_massiliensis	olsenella_umbonata	
olsenella_umbonata	ruminococcaceae_bacterium	h_e,h2o_e,acald_e,fe2_e,
ruminococcaceae_bacterium	olsenella_umbonata	
oscillatoria_acuminata	spiroplasma_diminutum	acald_e,
spiroplasma_diminutum	oscillatoria_acuminata	
paenibacillus_assamensis	parafilimonas_terrae	h2o_e,mal__L_e,val__L_e,
parafilimonas_terrae	paenibacillus_assamensis	pi_e,h2s_e,
paenibacillus_odorifer	tersicoccus_phoenicis	
tersicoccus_phoenicis	paenibacillus_odorifer	pi_e,gua_e,
paenibacillus_senegalensis	pelobacter_acetylenicus	nh4_e,
pelobacter_acetylenicus	paenibacillus_senegalensis	ade_e,
paenibacillus_taiwanensis	rhodoferax_antarcticus	fe2_e,
rhodoferax_antarcticus	paenibacillus_taiwanensis	acald_e,glyc_e,
paenibacillus_tuaregi	pseudooceanicola_atlanticus	h2o_e,h_e,gly_e,
pseudooceanicola_atlanticus	paenibacillus_tuaregi	
pajaroellobacter_abortibovis	spiroplasma_culicicola	h2o_e,h_e,
spiroplasma_culicicola	pajaroellobacter_abortibovis	cgly_e,ura_e,trp__L_e,succ_e,
palleronia_marisminoris	salsuginibacillus_kocurii	etoh_e,no2_e,h2s_e,
salsuginibacillus_kocurii	palleronia_marisminoris	h_e,gly_e,fe3_e,
pandoraea_thiooxydans	ruegeria_marina	
ruegeria_marina	pandoraea_thiooxydans	orn_e,
pannonibacter_phragmitetus	serinicoccus_profundi	h_e,pro__L_e,
serinicoccus_profundi	pannonibacter_phragmitetus	
pantoea_alhagi	yersinia_pestis	
yersinia_pestis	pantoea_alhagi	
pantoea_rwandensis	plesiocystis_pacifica	gly_e,
plesiocystis_pacifica	pantoea_rwandensis	h2o_e,
paraburkholderia_acidipaludis	rhizobium_oryzae	h2o_e,h_e,pi_e,akg_e,
rhizobium_oryzae	paraburkholderia_acidipaludis	
paraburkholderia_caballeronis	polynucleobacter_necessarius	fe2_e,
polynucleobacter_necessarius	paraburkholderia_caballeronis	glu__L_e,fum_e,
paraburkholderia_kururiensis	zunongwangia_mangrovi	
zunongwangia_mangrovi	paraburkholderia_kururiensis	pro__L_e,
paracoccus_aminophilus	pseudomonas_rhizosphaerae	h2o_e,
pseudomonas_rhizosphaerae	paracoccus_aminophilus	ade_e,
paracoccus_denitrificans	streptomyces_kebangsaanensis	
streptomyces_kebangsaanensis	paracoccus_denitrificans	pi_e,
paracoccus_halophilus	ruania_albidiflava	ade_e,
ruania_albidiflava	paracoccus_halophilus	
paracoccus_isoporae	polynucleobacter_cosmopolitanus	fe2_e,
polynucleobacter_cosmopolitanus	paracoccus_isoporae	
paracoccus_isoporae	sphingopyxis_macrogoltabida	
sphingopyxis_macrogoltabida	paracoccus_isoporae	glu__L_e,
paracoccus_saliphilus	spirosoma_rigui	fum_e,h2s_e,
spirosoma_rigui	paracoccus_saliphilus	pi_e,
paracoccus_tibetensis	tenacibaculum_soleae	
tenacibaculum_soleae	paracoccus_tibetensis	
paramesorhizobium_deserti	pseudonocardia_acaciae	fum_e,
pseudonocardia_acaciae	paramesorhizobium_deserti	
parapedobacter_composti	zymomonas_mobilis	asp__L_e,
zymomonas_mobilis	parapedobacter_composti	h2o_e,
parapedobacter_luteus	tistrella_mobilis	no2_e,glu__L_e,h_e,
tistrella_mobilis	parapedobacter_luteus	for_e,
parascardovia_denticolens	pseudoruegeria_sabulilitoris	nh4_e,no2_e,gly_e,cu2_e,
pseudoruegeria_sabulilitoris	parascardovia_denticolens	acald_e,
parasutterella_excrementihominis	prevotella_loescheii	etoh_e,ura_e,h2s_e,
prevotella_loescheii	parasutterella_excrementihominis	fe2_e,
parvibaculum_lavamentivorans	photobacterium_marinum	gly_e,ura_e,
photobacterium_marinum	parvibaculum_lavamentivorans	h2o_e,
pedobacter_arcticus	phycisphaera_mikurensis	glu__L_e,
phycisphaera_mikurensis	pedobacter_arcticus	pi_e,
pedobacter_glucosidilyticus	varibaculum_timonense	glu__L_e,val__L_e,
varibaculum_timonense	pedobacter_glucosidilyticus	h2s_e,
pedobacter_luteus	prevotella_falsenii	h_e,gthox_e,h_e,gthox_e,
prevotella_falsenii	pedobacter_luteus	h2o_e,h2o_e,h2o2_e,h2o2_e,asp__L_e,asp__L_e,
pedobacter_luteus	pricia_antarctica	glu__L_e,h_e,pro__L_e,glu__L_e,h_e,pro__L_e,
pricia_antarctica	pedobacter_luteus	pi_e,pi_e,for_e,for_e,
pedobacter_oryzae	psychrobacter_urativorans	
psychrobacter_urativorans	pedobacter_oryzae	glyc_e,
pedobacter_psychrophilus	xanthomonas_citri	asp__L_e,
xanthomonas_citri	pedobacter_psychrophilus	h2o_e,h2s_e,
pedobacter_steynii	rhizobium_miluonense	pi_e,
rhizobium_miluonense	pedobacter_steynii	h2s_e,
pedobacter_suwonensis	pseudoruegeria_marinistellae	for_e,pi_e,no2_e,cu2_e,
pseudoruegeria_marinistellae	pedobacter_suwonensis	h2o_e,nh4_e,
peptoniphilus_obesi	pontibacillus_litoralis	h2o_e,
pontibacillus_litoralis	peptoniphilus_obesi	no2_e,pi_e,trp__L_e,
perlucidibaca_aquatica	photobacterium_profundum	
photobacterium_profundum	perlucidibaca_aquatica	pyr_e,no2_e,h2o_e,
phaeobacter_gallaeciensis	rhodopseudomonas_palustris	h2o_e,
rhodopseudomonas_palustris	phaeobacter_gallaeciensis	fe3_e,
phocaeicola_abscessus	propionicicella_superfundia	nh4_e,h_e,
propionicicella_superfundia	phocaeicola_abscessus	h2o_e,
photobacterium_ganghwense	risungbinella_massiliensis	acald_e,h2o_e,
risungbinella_massiliensis	photobacterium_ganghwense	pi_e,fum_e,gly_e,
photobacterium_jeanii	pseudomonas_syringae	no2_e,lac__L_e,pro__L_e,adn_e,
pseudomonas_syringae	photobacterium_jeanii	
piscicoccus_intestinalis	terracidiphilus_gabretensis	
terracidiphilus_gabretensis	piscicoccus_intestinalis	ade_e,
planococcus_rifietoensis	ralstonia_pickettii	
ralstonia_pickettii	planococcus_rifietoensis	acald_e,thym_e,
planomicrobium_flavidum	thiohalorhabdus_denitrificans	nh4_e,
thiohalorhabdus_denitrificans	planomicrobium_flavidum	man1p_e,gua_e,
polyangium_brachysporum	ralstonia_pickettii	
ralstonia_pickettii	polyangium_brachysporum	
polycyclovorans_algicola	thalassolituus_oleivorans	glyc_e,cu2_e,
thalassolituus_oleivorans	polycyclovorans_algicola	pyr_e,h2o_e,
pontibacillus_yanchengensis	treponema_primitia	acald_e,fe2_e,pi_e,
treponema_primitia	pontibacillus_yanchengensis	fe3_e,h2o_e,val__L_e,pro__L_e,
porphyromonas_asaccharolytica	porphyromonas_somerae	
porphyromonas_somerae	porphyromonas_asaccharolytica	pi_e,h2s_e,thym_e,
poseidonocella_pacifica	pseudomonas_yangmingensis	ala__L_e,ala__D_e,
pseudomonas_yangmingensis	poseidonocella_pacifica	
prevotella_amnii	prevotella_timonensis	h_e,
prevotella_timonensis	prevotella_amnii	h2o_e,
prevotella_bryantii	sphingobacterium_mizutaii	h_e,ala__L_e,
sphingobacterium_mizutaii	prevotella_bryantii	pi_e,
prochlorothrix_hollandica	sinorhizobium_fredii	no2_e,fe3_e,cu2_e,
sinorhizobium_fredii	prochlorothrix_hollandica	pro__L_e,
providencia_sneebia	rosenbergiella_nectarea	
rosenbergiella_nectarea	providencia_sneebia	h2o_e,
providencia_stuartii	roseovarius_atlanticus	gly_e,nh4_e,
roseovarius_atlanticus	providencia_stuartii	acald_e,ala__L_e,
pseudarthrobacter_chlorophenolicus	robiginitalea_biformata	asp__L_e,hxan_e,pro__L_e,h2s_e,
robiginitalea_biformata	pseudarthrobacter_chlorophenolicus	
pseudoalteromonas_piscicida	sunxiuqinia_dokdonensis	nh4_e,
sunxiuqinia_dokdonensis	pseudoalteromonas_piscicida	pi_e,h_e,h2s_e,
pseudoalteromonas_rubra	thalassolituus_oleivorans	cu2_e,
thalassolituus_oleivorans	pseudoalteromonas_rubra	
pseudohaliea_rubra	thiohalomonas_denitrificans	nh4_e,
thiohalomonas_denitrificans	pseudohaliea_rubra	asp__L_e,
pseudomonas_aestusnigri	sulfuritalea_hydrogenivorans	glyc_e,
sulfuritalea_hydrogenivorans	pseudomonas_aestusnigri	h2o_e,fe3_e,
pseudomonas_alcaligenes	sphingomonas_sanxanigenens	
sphingomonas_sanxanigenens	pseudomonas_alcaligenes	pro__L_e,
pseudomonas_protegens	streptomyces_albus	pi_e,h_e,
streptomyces_albus	pseudomonas_protegens	
pseudomonas_syringae	vibrio_sonorensis	ade_e,
vibrio_sonorensis	pseudomonas_syringae	so3_e,asp__L_e,adn_e,gly_e,pi_e,pro__L_e,
pseudonocardia_acaciae	sanguibacter_keddieii	h2s_e,
sanguibacter_keddieii	pseudonocardia_acaciae	gly_e,
pseudonocardia_dioxanivorans	streptomyces_uncialis	h2o_e,h_e,
streptomyces_uncialis	pseudonocardia_dioxanivorans	no2_e,
pseudooceanicola_batsensis	streptomyces_caatingaensis	
streptomyces_caatingaensis	pseudooceanicola_batsensis	pi_e,no2_e,
pseudooceanicola_nanhaiensis	rubripirellula_obstinata	h2o_e,nh4_e,
rubripirellula_obstinata	pseudooceanicola_nanhaiensis	
pseudophaeobacter_arcticus	treponema_putidum	fe2_e,
treponema_putidum	pseudophaeobacter_arcticus	h_e,h2o_e,
pseudophaeobacter_leonis	xenorhabdus_koppenhoeferi	h_e,gly_e,cit_e,
xenorhabdus_koppenhoeferi	pseudophaeobacter_leonis	nh4_e,fe2_e,
pseudorhodobacter_aquimaris	verminephrobacter_eiseniae	h2o_e,
verminephrobacter_eiseniae	pseudorhodobacter_aquimaris	gua_e,
pseudorhodobacter_psychrotolerans	tropicibacter_multivorans	
tropicibacter_multivorans	pseudorhodobacter_psychrotolerans	h2o_e,
pseudosphingobacterium_domesticum	winogradskyella_jejuensis	pi_e,ac_e,
winogradskyella_jejuensis	pseudosphingobacterium_domesticum	glu__L_e,h2s_e,
psychroflexus_sediminis	spiroplasma_litorale	h_e,pi_e,pro__L_e,
spiroplasma_litorale	psychroflexus_sediminis	man1p_e,val__L_e,
psychroflexus_torquis	thermodesulfovibrio_thiophilus	pi_e,
thermodesulfovibrio_thiophilus	psychroflexus_torquis	
puniceibacterium_sediminis	sagittula_stellata	h2s_e,
sagittula_stellata	puniceibacterium_sediminis	
raineyella_antarctica	salinicoccus_halodurans	glu__L_e,
salinicoccus_halodurans	raineyella_antarctica	h2o_e,gly_e,
ralstonia_mannitolilytica	staphylococcus_lugdunensis	h2o_e,thym_e,
staphylococcus_lugdunensis	ralstonia_mannitolilytica	
rappaport_israeli	thermotoga_profunda	h2o_e,fe2_e,
thermotoga_profunda	rappaport_israeli	
reinekea_blandensis	streptomyces_cattleya	pyr_e,ade_e,
streptomyces_cattleya	reinekea_blandensis	
rhizobium_alamii	streptomyces_paucisporeus	acald_e,
streptomyces_paucisporeus	rhizobium_alamii	no2_e,
rhizobium_miluonense	salimicrobium_flavidum	
salimicrobium_flavidum	rhizobium_miluonense	pyr_e,
rhizobium_oryzae	syntrophothermus_lipocalidus	fe2_e,
syntrophothermus_lipocalidus	rhizobium_oryzae	pi_e,
rhodopirellula_sallentina	thermanaerovibrio_velox	
thermanaerovibrio_velox	rhodopirellula_sallentina	acald_e,
richelia_intracellularis	tenacibaculum_holothuriorum	h_e,ser__L_e,h2s_e,
tenacibaculum_holothuriorum	richelia_intracellularis	h2o_e,glu__L_e,
rickettsia_bellii	streptomyces_monomycini	h_e,fum_e,
streptomyces_monomycini	rickettsia_bellii	
roseivivax_jejudonensis	roseovarius_nanhaiticus	
roseovarius_nanhaiticus	roseivivax_jejudonensis	
rosenbergiella_nectarea	wigglesworthia_glossinidia	h2o_e,
wigglesworthia_glossinidia	rosenbergiella_nectarea	h_e,pi_e,
roseomonas_aerilata	stackebrandtia_nassauensis	nh4_e,
stackebrandtia_nassauensis	roseomonas_aerilata	pi_e,
roseovarius_halotolerans	rufibacter_tibetensis	
rufibacter_tibetensis	roseovarius_halotolerans	h2o_e,pi_e,
rubrivivax_gelatinosus	sphingobium_yanoikuyae	asp__L_e,
sphingobium_yanoikuyae	rubrivivax_gelatinosus	man1p_e,
rubrobacter_aplysinae	taylorella_equigenitalis	fum_e,nh4_e,pi_e,h2s_e,
taylorella_equigenitalis	rubrobacter_aplysinae	h2o_e,acald_e,thym_e,
ruegeria_meonggei	sphingobium_baderi	
sphingobium_baderi	ruegeria_meonggei	
saccharibacillus_kuerlensis	tumebacillus_flagellatus	h2o_e,h_e,
tumebacillus_flagellatus	saccharibacillus_kuerlensis	ade_e,
saccharomonospora_cyanea	saccharopolyspora_erythraea	
saccharopolyspora_erythraea	saccharomonospora_cyanea	h2o_e,pro__L_e,
salegentibacter_echinorum	sphingobacterium_wenxiniae	h2o_e,
sphingobacterium_wenxiniae	salegentibacter_echinorum	asp__L_e,pi_e,h2s_e,
salipaludibacillus_aurantiacus	thermotalea_metallivorans	h2o_e,
thermotalea_metallivorans	salipaludibacillus_aurantiacus	nh4_e,asp__L_e,cgly_e,
segetibacter_koreensis	sporosarcina_koreensis	pi_e,
sporosarcina_koreensis	segetibacter_koreensis	h_e,
segniliparus_rotundus	tanticharoenia_sakaeratensis	
tanticharoenia_sakaeratensis	segniliparus_rotundus	h2s_e,
shewanella_denitrificans	vibrio_litoralis	glu__L_e,glu__L_e,h2o_e,h2o_e,fe2_e,fe2_e,
vibrio_litoralis	shewanella_denitrificans	nh4_e,nh4_e,
shewanella_frigidimarina	simonsiella_muelleri	no2_e,fe2_e,
simonsiella_muelleri	shewanella_frigidimarina	ala__L_e,ura_e,orn_e,ade_e,
shewanella_japonica	terrimicrobium_sacchariphilum	
terrimicrobium_sacchariphilum	shewanella_japonica	ade_e,
shewanella_violacea	thalassotalea_crassostreae	no2_e,
thalassotalea_crassostreae	shewanella_violacea	pi_e,cgly_e,for_e,
sinorhizobium_meliloti	terrimicrobium_sacchariphilum	
terrimicrobium_sacchariphilum	sinorhizobium_meliloti	pi_e,ade_e,cu2_e,
sinosporangium_album	spirosoma_endophyticum	
spirosoma_endophyticum	sinosporangium_album	fum_e,
skermanella_stibiiresistens	thauera_chlorobenzoica	h2o_e,fe2_e,
thauera_chlorobenzoica	skermanella_stibiiresistens	ala__L_e,ala__D_e,
solemya_elarraichensis	thermodesulfobium_narugense	
thermodesulfobium_narugense	solemya_elarraichensis	
solibacillus_silvestris	yuhushiella_deserti	pi_e,
yuhushiella_deserti	solibacillus_silvestris	
sphingobacterium_deserti	terracidiphilus_gabretensis	pi_e,so3_e,
terracidiphilus_gabretensis	sphingobacterium_deserti	h2o_e,
sphingobacterium_spiritivorum	sporosarcina_ureae	pi_e,
sporosarcina_ureae	sphingobacterium_spiritivorum	h2o_e,
sphingobium_faniae	thermoflexibacter_ruber	asp__L_e,
thermoflexibacter_ruber	sphingobium_faniae	glyclt_e,
sphingomonas_azotifigens	waddlia_chondrophila	pi_e,
waddlia_chondrophila	sphingomonas_azotifigens	
sphingomonas_panacis	thalassobaculum_salexigens	acald_e,pi_e,
thalassobaculum_salexigens	sphingomonas_panacis	h2o_e,h_e,
spiroplasma_kunkelii	weissella_oryzae	h_e,pi_e,
weissella_oryzae	spiroplasma_kunkelii	orn_e,
sporosarcina_koreensis	terribacillus_aidingensis	h2o_e,h_e,
terribacillus_aidingensis	sporosarcina_koreensis	pi_e,cgly_e,
stanieria_cyanosphaera	staphylococcus_lugdunensis	
staphylococcus_lugdunensis	stanieria_cyanosphaera	
staphylococcus_capitis	staphylococcus_lugdunensis	h2o_e,pi_e,
staphylococcus_lugdunensis	staphylococcus_capitis	
staphylococcus_haemolyticus	staphylococcus_hominis	glu__L_e,
staphylococcus_hominis	staphylococcus_haemolyticus	h_e,
staphylococcus_massiliensis	streptomyces_katrae	fum_e,fe3_e,
streptomyces_katrae	staphylococcus_massiliensis	
streptomyces_nanshensis	thiobacimonas_profunda	h2o_e,
thiobacimonas_profunda	streptomyces_nanshensis	nh4_e,
sunxiuqinia_elliptica	virgibacillus_siamensis	h_e,h2o_e,
virgibacillus_siamensis	sunxiuqinia_elliptica	asp__L_e,orn_e,fe2_e,
taylorella_equigenitalis	thermosulfurimonas_dismutans	h2o_e,mal__L_e,
thermosulfurimonas_dismutans	taylorella_equigenitalis	h_e,asp__L_e,fum_e,ac_e,
thermanaerothrix_daxensis	thermomicrobium_roseum	fe2_e,
thermomicrobium_roseum	thermanaerothrix_daxensis	acald_e,
thermoanaerobacter_italicus	verrucomicrobium_spinosum	h_e,h2o_e,fe2_e,
verrucomicrobium_spinosum	thermoanaerobacter_italicus	pro__L_e,
thermovenabulum_gondwanense	treponema_phagedenis	acald_e,pi_e,
treponema_phagedenis	thermovenabulum_gondwanense	
thiolapillus_brandeum	vibrio_campbellii	nh4_e,for_e,
vibrio_campbellii	thiolapillus_brandeum	no2_e,cu2_e,
thioploca_ingrica	vibrio_genomosp	
vibrio_genomosp	thioploca_ingrica	
vibrio_cholerae	xenorhabdus_nematophila	
xenorhabdus_nematophila	vibrio_cholerae	cgly_e,
wigglesworthia_glossinidia	xenorhabdus_hominickii	h_e,pi_e,
xenorhabdus_hominickii	wigglesworthia_glossinidia	
